Clean_Player,Team,G,A,Pts,plus_minus,Sh,PIM,Games_Played
A.J. Hodges,Bentley,6,9,15,-1,57,2,29
A.J. Macaulay,Alaska,5,10,15,9,44,14,34
AJ Casperson,Long Island,0,1,1,1,7,2,12
Aaron Bohlinger,Massachusetts,3,5,8,1,22,4,34
Aaron Grounds,Long Island,1,2,3,-5,14,16,11
Aaron Huglen,Minnesota,13,8,21,-6,82,21,37
Aaron Pionk,Minnesota-Duluth,3,17,20,-9,88,22,37
Aaron Trotter,St. Thomas,0,2,2,0,0,0,24
Abram Wiebe,North Dakota,1,9,10,14,35,27,40
Adam Arvedson,Merrimack,1,3,4,-1,12,2,21
Adam Cardona,Mass.-Lowell,1,0,1,1,8,8,15
Adam Conquest,Lindenwood,3,5,8,-8,29,28,27
Adam Eisele,Minnesota State,8,15,23,3,96,16,37
Adam Flammang,Bemidji State,9,10,19,18,89,24,38
Adam Ingram,St. Cloud State,10,18,28,9,77,18,38
Adam Jeffery,RIT,1,1,2,5,18,4,11
Adam Pitters,Long Island,4,5,9,3,36,10,30
Adam Robbins,Princeton,11,18,29,-3,80,8,30
Adam Schankula,Bowling Green,1,2,3,0,28,0,14
Adam Tisdale,Alaska-Anchorage,5,8,13,-6,45,4,34
Adrien Bisson,Mercyhurst,2,6,8,-8,23,16,23
Aidan Connolly,Sacred Heart,0,0,0,-2,4,2,2
Aidan Hreschuk,Boston College,2,13,15,21,38,32,41
Aidan Thompson,Denver,11,19,30,16,93,35,44
Aiden Celebrini,Boston University,1,5,6,7,17,20,36
Aiden Dubinsky,Minnesota-Duluth,3,12,15,-12,34,20,37
Aiden Fink,Penn State,15,19,34,-3,110,27,34
Aiden Gallacher,Northern Michigan,3,5,8,-2,41,25,34
Aiden Hansen-Bukata,RIT,5,26,31,23,60,28,37
Aiden Westin,Alaska-Anchorage,7,9,16,1,35,17,29
Aiden Yakimchuk,Lindenwood,5,5,10,-5,25,6,16
Aksel Reid,Union,0,0,0,0,0,0,1
Akseli Pennanen,American Int'l,0,1,1,-1,2,0,7
Aku Koskenvuo,Harvard,0,0,0,0,0,0,17
Albin Boija,Maine,0,1,1,0,0,0,18
Albin Nilsson,Miami,4,5,9,-12,23,2,17
Alec Cicero,Holy Cross,11,7,18,-3,93,35,39
Alex Bump,Western Michigan,14,22,36,7,160,27,38
Alex Campbell,Northeastern,22,20,42,13,110,6,36
Alex DiPaolo,Colgate,12,11,23,1,60,16,26
Alex Gaffney,Harvard,8,2,10,-18,42,0,31
Alex Gagne,New Hampshire,1,13,14,13,50,24,36
Alex Gomez,Alaska-Anchorage,1,3,4,-6,18,6,23
Alex Houston,Canisius,0,0,0,0,0,0,1
Alex Jefferies,Merrimack,13,10,23,1,69,19,22
Alex Konovalov,Princeton,0,1,1,-2,10,2,14
Alex Krause,Dartmouth,1,1,2,0,17,15,18
Alex Murray,Niagara,1,12,13,-2,35,10,22
Alex Nordstrom,Michigan Tech,4,4,8,6,35,6,26
Alex Peterson,Mass.-Lowell,1,3,4,-10,34,16,30
Alex Pineau,Brown,7,8,15,-20,80,20,30
Alex Power,Quinnipiac,4,5,9,8,20,2,31
Alex Servagno,Penn State,2,4,6,-5,46,2,30
Alex Tracy,Minnesota State,0,1,1,0,0,0,28
Alex Weiermair,Denver,3,3,6,2,10,2,24
Alex Young,Arizona State,6,3,9,-5,61,8,37
Alexander Lundman,Bemidji State,3,5,8,-5,17,4,20
Alexander Malinowski,American Int'l,9,11,20,5,68,23,27
Alexander Tertyshny,Stonehill,0,3,3,-23,19,16,28
Alexandros Aslanidis,American Int'l,0,0,0,0,0,0,9
Alfred Lindberg,American Int'l,11,11,22,6,43,6,20
Altti Nykanen,Rensselaer,1,3,4,4,9,0,7
Andon Cerbone,Quinnipiac,12,14,26,20,90,23,39
Andre Gasseau,Boston College,12,17,29,17,83,27,40
Andre Ghantous,Northern Michigan,9,23,32,-3,71,48,34
Andrei Buyalsky,Vermont,3,8,11,-5,48,8,25
Andrew Amousse,American Int'l,1,0,1,-1,4,4,10
Andrew Centrella,Providence,0,3,3,5,15,0,18
Andrew DeCarlo,Air Force,5,9,14,-4,43,12,32
Andrew Garby,Army,2,0,2,-3,7,2,10
Andrew Gilbert,Army,0,0,0,-12,19,10,33
Andrew Lucas,Connecticut,5,11,16,3,76,16,36
Andrew Noel,Ferris State,1,3,4,-2,29,4,35
Andrew Takacs,Colgate,0,0,0,0,0,2,3
Andrius Kulbis-Marino,Sacred Heart,5,5,10,-2,49,14,36
Andy Moore,Northeastern,0,1,1,2,11,12,31
Anthony Calafiore,Maine,2,2,4,-4,17,0,19
Anthony Cipollone,Quinnipiac,7,6,13,13,31,2,36
Anthony Dowd,Arizona State,3,10,13,-1,58,12,36
Anthony Galante,Stonehill,5,2,7,-27,48,10,31
Anthony Kehrer,Wisconsin,2,7,9,17,47,23,38
Anthony Menghini,Minnesota-Duluth,8,2,10,6,76,43,37
Anthony Messuri,Northeastern,0,0,0,-1,0,0,3
Anthony Mollica,St. Lawrence,0,1,1,-2,3,0,5
Anthony Romano,Clarkson,10,15,25,-3,79,4,27
Anthony Stark,Augustana,2,3,5,-2,17,4,30
Anton Rubtsov,Alaska,8,20,28,6,63,14,30
Antonio Fernandez,Colorado College,0,0,0,0,1,0,2
Antonio Venuto,Ferris State,12,14,26,0,88,44,36
Aram Minnetian,Boston College,3,6,9,11,31,29,40
Arlo Merritt,Bentley,6,6,12,-3,53,4,30
Arnaud Vachon,Augustana,8,8,16,-4,68,27,34
Aron Jessli,Niagara,1,3,4,-11,28,0,28
Arseni Sergeyev,Connecticut,0,0,0,0,0,0,16
Artem Shlaine,Northern Michigan,10,13,23,-5,78,23,27
Arthur Smith,Princeton,0,0,0,0,0,0,20
Artur Turansky,Miami,4,5,9,-21,62,6,35
Artyom Borshyov,Lake Superior,2,6,8,-8,30,12,36
Artyom Levshunov,Michigan State,9,26,35,27,82,44,38
Arvid Caderoth,Michigan Tech,7,6,13,-8,62,14,35
Arvils Bergmanis,Alaska,2,17,19,8,47,39,31
Atte Lehikoinen,Long Island,0,0,0,-3,2,2,6
Austen Long,American Int'l,8,8,16,5,54,27,38
Austen May,Providence,4,9,13,4,68,4,30
Austen Swankler,Michigan Tech,0,3,3,-4,27,10,10
Austin Brimmer,Long Island,7,8,15,-6,48,12,30
Austin Fraser,Lindenwood,2,2,4,-5,18,30,24
Austin Heidemann,Rensselaer,11,16,27,-12,84,8,37
Austin Jouppi,Bemidji State,2,17,19,4,57,16,37
Austin McCarthy,Ferris State,3,2,5,-5,26,4,20
Austin Oravetz,Michigan State,0,5,5,8,20,15,33
Austin Roden,Clarkson,0,1,1,0,0,0,25
Austin Schwartz,Air Force,10,9,19,6,91,10,38
Axel Begley,Minnesota,0,0,0,-2,4,0,14
Axel Kumlin,Miami,2,9,11,-12,66,10,34
Axel Mangbo,Vermont,0,0,0,0,0,0,3
Aydar Suniev,Massachusetts,12,13,25,1,101,25,36
Ayrton Martino,Clarkson,9,18,27,-5,69,8,31
Barrett Brooks,Mercyhurst,4,6,10,-5,27,23,27
Barrett Hall,St. Cloud State,8,8,16,-5,60,16,33
Barron Woodring,Army,5,3,8,-6,50,16,31
Bayard Hall,Yale,1,5,6,-12,50,10,30
Ben Almquist,Alaska-Anchorage,14,16,30,10,84,14,34
Ben Anderson,Alaska-Anchorage,0,1,1,0,7,14,11
Ben Brar,Merrimack,5,14,19,-18,98,20,35
Ben Brunette,Mass.-Lowell,1,0,1,1,11,4,13
Ben Dexheimer,Wisconsin,5,23,28,2,75,16,40
Ben Doran,Bowling Green,3,7,10,-4,18,28,25
Ben Kraws,St. Lawrence,0,0,0,0,0,0,37
Ben MacDonald,Harvard,5,10,15,-10,66,36,32
Ben Meehan,Mass.-Lowell,1,11,12,-5,47,31,25
Ben Poisson,Maine,6,9,15,0,94,21,37
Ben Raymond,Colgate,4,7,11,2,48,6,35
Ben Robertson,Cornell,5,18,23,19,76,2,35
Ben Schultheis,Ferris State,0,2,2,-8,20,6,21
Ben Steeves,Minnesota-Duluth,24,10,34,-10,147,30,37
Ben Strinden,North Dakota,6,6,12,6,56,18,39
Ben Troumbly,Augustana,5,8,13,-9,31,14,28
Ben Tupker,Union,9,10,19,5,63,24,34
Ben Wozney,Bowling Green,2,7,9,-3,35,16,22
Beni Halasz,Northern Michigan,0,0,0,0,0,15,28
Benito Posa,Lake Superior,0,0,0,-4,5,2,4
Benji Eckerle,Arizona State,5,15,20,8,61,12,35
Bennett Schimek,Providence,8,9,17,8,70,6,34
Bennett Zmolek,North Dakota,0,8,8,17,27,22,33
Billy Norcross,Northeastern,0,4,4,-1,18,4,26
Blais Richartz,Michigan Tech,3,4,7,5,46,8,31
Blake Biondi,Minnesota-Duluth,8,11,19,-20,77,29,34
Blake Dangos,Sacred Heart,1,3,4,-4,22,16,19
Blake Humphrey,Sacred Heart,2,4,6,-4,28,4,23
Blake Mesenburg,Miami,2,1,3,-10,41,16,36
Blake Pietila,Michigan Tech,0,1,1,0,0,0,37
Blake Wells,American Int'l,4,6,10,3,31,12,32
Bo Cosman,Massachusetts,0,1,1,0,4,0,3
Bobby Metz,Colgate,2,2,4,10,27,2,36
Bodie Nobes,Maine,0,0,0,-1,18,17,19
Boris Skalos,Mercyhurst,15,12,27,2,110,10,35
Boston Buckberger,Denver,5,22,27,32,79,27,44
Brad McNeil,Rensselaer,4,4,8,-2,34,9,36
Braden Birnie,Alaska,3,14,17,14,50,21,33
Braden Doyle,Northeastern,1,0,1,-3,6,0,13
Braden Fischer,Minnesota-Duluth,1,4,5,2,11,2,22
Bradly Nadeau,Maine,19,27,46,20,109,12,37
Brady Berard,Providence,2,6,8,7,36,16,27
Brady Bjork,Notre Dame,0,1,1,1,2,2,5
Brady Cleveland,Wisconsin,0,0,0,-3,4,19,16
Brady Egan,Clarkson,0,1,1,-2,10,2,18
Brady Hunter,Merrimack,0,2,2,-1,7,2,11
Brady Parker,Clarkson,0,0,0,0,0,0,6
Brady Risk,Alaska,13,20,33,5,109,16,33
Brady Ziemer,Augustana,3,7,10,-9,33,10,34
Braeden Tuck,Sacred Heart,6,11,17,-3,41,6,33
Braidan Simmons-Fischer,St. Thomas,0,1,1,-1,3,6,6
Braiden Dorfman,Dartmouth,8,9,17,1,50,36,29
Branden Piku,Lake Superior,7,4,11,6,41,14,25
Brandon Buhr,Union,11,13,24,-12,70,4,35
Brandon Chabrier,Maine,6,16,22,8,64,22,37
Brandon Holt,Maine,4,11,15,10,60,18,33
Brandon Koch,Minnesota State,1,13,14,4,60,18,34
Brandon Lajoie,Alaska-Anchorage,0,4,4,2,5,2,7
Brandon Perrone,Long Island,0,1,1,0,0,2,24
Brandon Santa Juana,Bowling Green,2,9,11,-11,33,16,36
Brandon Tabakin,Arizona State,2,8,10,26,66,13,36
Brayden Krieger,Bowling Green,0,5,5,-7,37,0,26
Brayden Morrison,Miami,0,1,1,-5,14,6,26
Brayden Nicholetts,Alaska,3,1,4,2,20,10,17
Breck McKinley,Bowling Green,0,6,6,-12,30,6,31
Brehdan Engum,Mass.-Lowell,0,4,4,-8,34,39,34
Brendan Budy,Rensselaer,0,0,0,-5,8,8,15
Brendan Clark,Brown,0,3,3,-4,15,14,16
Brendan Dumas,Sacred Heart,2,0,2,-2,8,18,12
Brendan Fitzgerald,New Hampshire,0,5,5,-4,22,44,28
Brendan Gibbons,Air Force,7,5,12,-7,46,14,34
Brendan Gorman,Princeton,7,17,24,5,58,19,29
Brendan Miles,Michigan,0,0,0,-1,0,0,6
Brendan Poshak,Northern Michigan,0,0,0,1,5,0,7
Brendan Wang,Princeton,0,1,1,-13,19,8,25
Brenden Datema,Canisius,1,8,9,-3,47,30,35
Brenden MacLaren,Ferris State,0,2,2,-15,41,11,27
Brenden Olson,Minnesota State,3,1,4,-4,20,10,23
Brenden Rons,Lindenwood,0,3,3,-7,21,18,27
Brennan Ali,Notre Dame,3,10,13,3,53,4,36
Brent Johnson,Ohio State,5,8,13,-1,50,8,37
Brent Keefer,Army,13,11,24,-14,70,30,34
Bret Link,Colorado College,4,11,15,8,53,6,35
Brett Bamber,Alaska-Anchorage,4,9,13,8,72,17,34
Brett Bliss,Brown,2,7,9,-22,58,27,30
Brett Callahan,American Int'l,4,6,10,1,66,10,37
Brett Chorske,Colgate,7,20,27,9,63,6,35
Brett Edwards,Northeastern,5,2,7,-2,17,18,31
Brett Meerman,Augustana,3,10,13,-7,37,2,29
Brett Miller,Rensselaer,0,0,0,0,0,0,7
Brett Moravec,Minnesota State,4,4,8,6,44,10,27
Brett Pfoh,Bowling Green,9,6,15,-3,62,28,34
Brett Roloson,Lake Superior,1,5,6,1,11,6,15
Brett Rylance,American Int'l,6,14,20,-5,66,31,38
Brian Adams,Air Force,2,6,8,7,36,4,30
Brian Carrabes,Minnesota State,10,12,22,6,94,6,36
Brian Chambers,Arizona State,4,16,20,4,51,35,38
Brian Kramer,American Int'l,10,12,22,10,66,35,35
Brian Silver,Augustana,0,0,0,-7,5,8,16
Briggs Gammill,Yale,8,7,15,0,66,24,28
Brock Bremer,Omaha,8,12,20,1,81,46,40
Brody Gagno,Holy Cross,0,3,3,4,15,14,38
Brody Lamb,Minnesota,12,15,27,-1,73,6,39
Brody Waters,Bowling Green,6,9,15,-8,43,25,34
Broten Sabo,Alaska,1,2,3,7,27,10,28
Bruno Bruveris,Miami,0,0,0,0,0,0,15
Bryan Huggins,Lake Superior,0,4,4,-4,20,6,30
Bryce Brodzinski,Minnesota,14,22,36,21,106,18,39
CJ Foley,Dartmouth,5,15,20,5,87,10,32
CJ McGee,Quinnipiac,2,7,9,15,33,33,39
CJ Regula,Rensselaer,2,5,7,-3,45,22,29
Cade Ahrenholz,Alaska,5,0,5,-4,27,10,23
Cade Alami,Arizona State,0,2,2,-2,10,16,14
Cade DeStefani,Lindenwood,2,2,4,1,15,6,9
Cade Mason,Long Island,2,25,27,-6,60,8,32
Cade Neilson,Alaska,5,14,19,8,52,22,31
Cade Townend,Robert Morris,4,10,14,-6,76,26,38
Cade Webber,Boston University,0,6,6,15,22,30,38
Caden Brown,Ohio State,4,6,10,-4,27,6,24
Caden Lewandowski,Clarkson,0,1,1,-2,6,4,12
Caden Villegas,Union,12,18,30,-12,76,4,37
Caiden Gault,Ferris State,2,3,5,-5,31,4,19
Caige Sterzer,Lindenwood,8,14,22,-6,59,35,28
Cal Kiefiuk,Providence,2,8,10,-1,41,24,25
Cal Mell,Union,0,7,7,-4,11,12,35
Cal Thomas,Minnesota,1,9,10,12,36,8,38
Cale Ashcroft,Denver,1,6,7,-2,34,4,37
Caleb Huffman,Alaska-Anchorage,0,1,1,-7,27,57,30
Caleb MacDonald,Alaska,4,10,14,13,38,38,31
Caleb Moretz,RIT,1,5,6,4,39,8,39
Caleb Price,Lindenwood,4,6,10,-3,56,6,27
Callum Gau,Augustana,2,3,5,-6,25,20,28
Cam Gendron,New Hampshire,1,2,3,2,9,2,10
Cam Johnson,Harvard,4,12,16,1,47,4,32
Cam Knuble,Western Michigan,0,1,1,0,16,4,28
Cam Kungle,Lake Superior,1,8,9,1,21,33,37
Cam Lund,Northeastern,11,19,30,-7,91,22,35
Cam MacDonald,Dartmouth,4,9,13,4,49,8,31
Cam Mannion,Stonehill,0,0,0,-20,8,8,17
Cam McDonald,Providence,1,6,7,5,23,8,29
Cam Mitchell,Omaha,0,1,1,0,13,4,13
Cam O'Neill,Massachusetts,3,4,7,0,26,23,28
Cam Thiesing,Ohio State,9,7,16,-9,111,55,31
Cameron Berg,North Dakota,20,17,37,7,116,8,40
Cameron Buhl,St. Lawrence,4,2,6,-7,53,6,26
Cameron Collins,Stonehill,0,1,1,-11,9,2,17
Cameron Garvey,Robert Morris,11,3,14,0,60,19,37
Cameron Gaudette,Stonehill,1,3,4,-34,21,36,33
Cameron Hebert,Robert Morris,2,5,7,-3,35,20,33
Cameron Recchi,St. Thomas,1,0,1,-3,3,2,5
Cameron Ricotta,Mercyhurst,1,1,2,2,6,0,5
Cameron Rowe,Western Michigan,0,0,0,0,0,0,38
Cameron Whitehead,Northeastern,0,0,0,0,0,2,35
Campbell Cichosz,Minnesota State,1,3,4,1,44,8,36
Carl Fish,Minnesota,0,3,3,8,31,15,38
Carson Albrecht,North Dakota,2,1,3,-1,19,8,26
Carson Bantle,Wisconsin,14,5,19,7,97,45,39
Carson Buydens,Princeton,2,1,3,-10,27,12,22
Carson Cherepak,Rensselaer,0,0,0,0,0,0,9
Carson Dyck,Penn State,0,2,2,-7,27,16,30
Carson Kosobud,Alaska-Anchorage,1,7,8,1,53,33,33
Carson Peters,St. Thomas,0,3,3,0,32,22,37
Carter Batchelder,Lake Superior,8,7,15,-6,53,14,34
Carter Belitski,Alaska-Anchorage,0,1,1,-1,9,2,14
Carter Berger,Western Michigan,4,16,20,14,78,14,36
Carter Clafton,Air Force,0,0,0,0,0,0,1
Carter Gylander,Colgate,0,1,1,0,0,0,32
Carter Jones,Bemidji State,6,18,24,-1,52,12,37
Carter King,Denver,15,19,34,8,98,2,37
Carter Korpi,Union,10,3,13,6,45,36,35
Carter Loney,Minnesota-Duluth,3,2,5,-8,29,31,33
Carter McPhail,Miami,0,0,0,0,0,0,2
Carter Randklev,Niagara,11,20,31,5,75,39,37
Carter Rose,Clarkson,1,0,1,0,7,4,15
Carter Schade,Penn State,0,0,0,-9,34,15,21
Carter Slaggert,Notre Dame,3,4,7,-11,27,24,32
Carter Wilkie,RIT,16,25,41,20,136,32,40
Case McCarthy,Boston University,4,5,9,19,44,10,39
Casey Aman,Penn State,1,1,2,2,12,2,20
Casey McDonald,American Int'l,4,3,7,-8,54,22,31
Casey Severo,Harvard,8,5,13,-3,35,6,32
Casper Soderling,American Int'l,1,3,4,-4,12,2,12
Cedric Fiedler,Western Michigan,0,8,8,24,30,23,38
Chad Hillebrand,Western Michigan,7,19,26,21,72,44,38
Chad Veltri,Robert Morris,0,1,1,0,0,0,32
Charles Banquier,Stonehill,2,2,4,-12,14,26,15
Charles Merkley,Robert Morris,0,0,0,-3,2,0,9
Charles-Alexis Legault,Quinnipiac,9,15,24,36,70,53,39
Charlie Glockner,Northern Michigan,0,0,0,0,0,0,9
Charlie Leddy,Boston College,0,8,8,15,19,12,39
Charlie Lurie,Omaha,0,1,1,0,6,2,4
Charlie Russell,Clarkson,0,0,0,-4,5,0,7
Charlie Schoen,Arizona State,8,16,24,5,45,31,33
Charlie Spence,Holy Cross,0,1,1,-3,3,4,14
Charlie Stramel,Wisconsin,3,5,8,-4,42,20,34
Charlie Strobel,Minnesota,2,1,3,1,21,17,29
Chase Bradley,Connecticut,11,11,22,4,101,53,31
Chase Brand,Augustana,5,7,12,-12,36,15,30
Chase Cheslock,St. Thomas,1,2,3,-3,27,6,19
Chase Clark,Sacred Heart,0,1,1,0,0,0,19
Chase Dafoe,Alaska,7,7,14,4,38,54,31
Chase Davis,Bentley,8,8,16,-5,60,18,35
Chase Dubois,Alaska,6,7,13,7,44,19,30
Chase Foley,Colorado College,2,14,16,0,41,6,32
Chase Hamm,Arizona State,0,0,0,0,0,0,1
Chase McLane,Penn State,3,3,6,-11,28,11,17
Chase Pietila,Michigan Tech,3,19,22,1,78,60,40
Chase Pletzke,Michigan,1,1,2,3,14,0,30
Chase Ramsay,Quinnipiac,0,0,0,-1,1,0,4
Chase Stevenson,Merrimack,4,0,4,-8,28,10,15
Chase Yoder,Providence,11,9,20,-3,85,26,35
Chaz Smedsrud,Union,14,8,22,-8,72,6,37
Chikara Hanzawa,Sacred Heart,2,0,2,-6,27,6,28
Chris Hedden,Air Force,8,29,37,-15,148,37,38
Chris Pappas,Long Island,10,19,29,-3,63,10,32
Chris Theodore,Vermont,8,6,14,-9,44,0,30
Christian Berger,Penn State,2,4,6,-10,39,6,30
Christian Catalano,RIT,9,8,17,13,77,60,36
Christian Felton,Merrimack,3,4,7,-3,39,4,26
Christian Fitzgerald,Wisconsin,7,17,24,8,88,16,37
Christian Gorscak,Niagara,1,1,2,-2,10,4,23
Christian Jimenez,Harvard,0,1,1,-9,23,12,18
Christian MacDougall,Canisius,1,0,1,0,5,4,7
Christian Sanda,Massachusetts,0,2,2,-4,5,4,15
Christian Sarlo,Penn State,2,6,8,-8,47,2,25
Christian Stoever,Bowling Green,0,1,1,0,0,2,14
Christophe Fillion,Quinnipiac,12,7,19,11,65,29,39
Clayton Cosentino,Air Force,10,18,28,-9,62,6,38
Clint Levens,Providence,0,3,3,-1,28,31,24
Cody Laskosky,RIT,14,27,41,16,125,26,37
Cody Monds,Clarkson,7,8,15,-7,35,21,30
Cody Schiavon,Canisius,3,5,8,2,16,21,28
Colby Ambrosio,Boston College,2,6,8,-4,58,10,40
Colby Enns,Northern Michigan,1,3,4,2,43,4,28
Colby MacArthur,Union,4,6,10,-3,33,4,29
Cole Brady,Massachusetts,0,0,0,0,0,2,9
Cole Burtch,Western Michigan,0,1,1,0,0,4,3
Cole Craft,Lake Superior,2,2,4,-1,19,4,17
Cole Crusberg-Roseen,Western Michigan,0,3,3,6,37,10,22
Cole Galata,Sacred Heart,0,2,2,-8,10,4,20
Cole Gordon,Arizona State,3,0,3,4,31,23,30
Cole Hanson,Maine,4,4,8,-3,34,4,34
Cole Helm,Arizona State,0,1,1,1,3,17,6
Cole Hudson,American Int'l,0,0,0,0,0,0,1
Cole Knuble,Notre Dame,9,11,20,4,89,12,36
Cole Kodsi,Union,3,1,4,-11,25,8,16
Cole Mickel,Niagara,2,3,5,-5,26,4,28
Cole Miller,St. Thomas,1,6,7,0,28,47,37
Cole Moore,Bowling Green,0,0,0,0,0,0,25
Cole O'Hara,Massachusetts,7,11,18,-1,71,18,37
Cole Spicer,Minnesota-Duluth,5,4,9,2,31,8,17
Collin Graf,Quinnipiac,22,27,49,23,123,4,34
Coltan Wilkie,Lindenwood,1,3,4,-1,18,24,17
Colton Cameron,Bentley,2,3,5,2,16,10,24
Colton Friesen,Augustana,3,8,11,-3,36,6,24
Colton Huard,New Hampshire,5,17,22,1,85,16,36
Conner Hutchison,Sacred Heart,1,4,5,-4,18,2,14
Connor Callaghan,Princeton,0,0,0,0,0,0,5
Connor Caponi,Denver,5,9,14,4,36,26,44
Connor Eddy,Northern Michigan,7,6,13,-6,55,40,34
Connor Gregga,Minnesota State,2,2,4,-4,30,8,28
Connor Hasley,Bentley,0,0,0,0,0,2,21
Connor Hopkins,Northeastern,0,0,0,0,0,0,3
Connor Joyce,Boston College,2,4,6,-1,34,6,35
Connor Kelley,Providence,1,11,12,7,29,12,34
Connor Kurth,Minnesota,7,14,21,-5,68,14,37
Connor Marritt,Alaska-Anchorage,7,7,14,6,51,7,33
Connor Mayer,Colorado College,0,5,5,11,51,24,37
Connor McGrath,Ferris State,1,3,4,-11,35,6,28
Connor McMenamin,Minnesota-Duluth,6,15,21,-9,67,12,35
Connor Milburn,Lake Superior,16,19,35,14,81,30,34
Connor Mylymok,Niagara,6,5,11,-1,64,61,37
Connor Pelc,Mercyhurst,1,4,5,-5,39,14,29
Connor Sullivan,Yale,0,5,5,-12,38,29,30
Connor Sweeney,New Hampshire,0,4,4,-2,20,8,32
Connor Welsh,Holy Cross,0,1,1,1,9,4,13
Conor Cole,Alaska-Anchorage,0,3,3,-7,14,14,20
Conor Lovett,New Hampshire,1,2,3,0,9,0,20
Conor Ronayne,Stonehill,0,5,5,-34,31,32,33
Cooper Black,Dartmouth,0,1,1,0,0,0,30
Cooper Connell,Bentley,0,0,0,0,1,0,2
Cooper Flinton,Dartmouth,15,10,25,1,71,25,30
Cooper Gay,St. Thomas,12,9,21,3,95,28,29
Cooper Haar,Canisius,1,5,6,-5,25,16,25
Cooper Moore,Quinnipiac,3,19,22,26,88,26,39
Cooper Wylie,St. Cloud State,3,3,6,-2,46,15,38
Craig Needham,Providence,4,7,11,-4,50,31,34
Cristophe Tellier,Quinnipiac,7,19,26,11,70,12,39
Crossley Stewart,RIT,2,6,8,7,36,23,30
Cruz Lucius,Wisconsin,13,21,34,0,116,10,36
Cullen DeYoung,Sacred Heart,0,0,0,0,0,0,3
Cullen Ferguson,Union,3,15,18,3,80,60,37
Cutter Gauthier,Boston College,38,27,65,23,212,18,41
Cy LeClerc,New Hampshire,10,18,28,7,94,17,36
DJ Hart,Union,1,4,5,-6,21,25,22
Daimon Gardner,Clarkson,1,5,6,-7,36,8,29
Dallas Tulik,Robert Morris,6,17,23,-12,51,24,37
Dalton Bancroft,Cornell,12,19,31,14,77,25,34
Dalton Messina,Ohio State,6,8,14,-10,56,20,38
Dalton Norris,Bowling Green,5,5,10,-9,53,19,23
Damien Carfagna,Ohio State,2,4,6,-10,57,10,34
Dane Dowiak,Penn State,6,5,11,-16,65,24,31
Dane Montgomery,North Dakota,1,1,2,1,9,0,16
Daniel Baldassarra,Long Island,0,0,0,-2,2,4,8
Daniel Chenard,RIT,0,0,0,0,0,0,1
Daniel Ebrahim,Sacred Heart,9,3,12,-4,78,19,31
Daniel Hilsendager,Western Michigan,1,7,8,5,52,19,33
Daniel Laatsch,Wisconsin,2,9,11,17,51,6,40
Daniel Panetta,Colgate,13,16,29,2,95,6,36
Daniel Russell,Michigan State,13,12,25,5,102,38,38
Daniel Sambuco,Vermont,1,0,1,-2,8,12,13
Danny Ciccarello,Rensselaer,4,1,5,-7,27,6,25
Danny Dzhaniyev,Penn State,9,20,29,12,98,6,33
Danny Nelson,Notre Dame,9,14,23,5,92,32,30
Danny Pearson,Bentley,0,0,0,-1,1,4,2
Danny Weight,Colorado College,1,0,1,-2,7,0,6
Dans Locmelis,Massachusetts,7,7,14,7,52,4,30
Dante Fantauzzi,Sacred Heart,2,11,13,1,38,32,35
Darian Gotz,Minnesota-Duluth,0,6,6,-8,50,37,37
Dario Beljo,American Int'l,2,4,6,2,16,12,16
Darwin Lakoduk,American Int'l,0,0,0,-2,4,4,12
David Andreychuk,Yale,3,9,12,-10,39,14,30
David Breazeale,Maine,2,7,9,9,76,10,37
David Chen,Yale,9,9,18,-2,69,19,30
David Fessenden,Canisius,0,3,3,0,0,8,22
David Gagnon,Lindenwood,8,8,16,-8,78,25,28
David Gucciardi,Michigan State,2,6,8,8,40,47,30
David Hejduk,Harvard,0,1,1,-4,11,8,22
David Hymovitch,Arizona State,0,0,0,0,2,0,2
David Jacobs,Princeton,7,17,24,-3,82,18,30
David Melaragni,Canisius,2,11,13,2,56,16,32
David Posma,Niagara,1,2,3,-4,13,2,15
David Sacco,Merrimack,1,1,2,2,15,23,18
David Silye,Wisconsin,9,23,32,-4,97,10,40
Davis Burnside,Ohio State,9,17,26,-6,97,24,38
Davis Fry,Mercyhurst,0,0,0,-2,1,2,5
Davis Goukler,Alaska-Anchorage,1,2,3,13,30,6,24
Davis Pennington,Quinnipiac,3,21,24,23,94,14,39
Dawson Bruneski,Alaska,2,4,6,1,16,70,29
Dawson Good,Vermont,1,2,3,3,8,2,9
Dawson Tritt,Lake Superior,13,12,25,-1,80,14,38
Dean Bauchiero,Brown,1,0,1,-8,7,6,21
Dean Schwenninger,Stonehill,4,9,13,-19,47,32,34
Derek Mullahy,Harvard,0,1,1,0,0,0,17
Derek Pys,Alaska,0,1,1,1,2,17,4
Devin Kaplan,Boston University,5,18,23,9,49,34,37
Devin Phillips,Holy Cross,1,2,3,1,10,2,5
Devlin O'Brien,Merrimack,3,5,8,-6,22,24,30
Devon Carlstrom,Stonehill,0,2,2,-30,21,10,33
Dillan Bentley,Mass.-Lowell,4,8,12,-11,57,12,32
Dimitri Mikrogiannakis,RIT,2,7,9,16,53,41,40
Dom Foglia,Colgate,2,4,6,3,29,4,24
Dominic Basse,St. Cloud State,0,1,1,0,0,2,25
Dominic James,Minnesota-Duluth,0,1,1,0,6,0,2
Dominic Schimizzi,Robert Morris,2,1,3,-3,23,10,16
Dominic Vidoli,Omaha,1,1,2,3,18,6,19
Dominick Campione,Stonehill,3,3,6,-25,19,39,23
Donavan Villeneuve-Houle,Maine,9,15,24,10,88,33,36
Donte Lawson,Bemidji State,4,3,7,3,22,0,17
Doug Grimes,Boston University,2,1,3,3,20,2,23
Douglas Andersson,American Int'l,0,0,0,-3,6,6,7
Douglas Scott,RIT,0,0,0,-1,5,14,7
Dovar Tinling,Rensselaer,5,12,17,-7,51,43,34
Drake Burgin,St. Lawrence,7,13,20,-7,74,16,39
Drew Bavaro,Notre Dame,10,10,20,-4,117,38,35
Drew Cooper,Ferris State,2,3,5,-4,23,4,24
Drew Fortescue,Boston College,4,4,8,13,30,36,40
Drew Kuzma,Lindenwood,4,6,10,-7,44,43,25
Drew Montgomery,Colorado College,5,5,10,1,35,12,35
Drew Vieten,Niagara,3,1,4,7,21,21,21
Duncan Ramsay,Vermont,0,1,1,0,7,6,26
Dustin Geregach,Mercyhurst,4,14,18,-13,64,35,34
Dustin Manz R,American Int'l,7,24,31,1,87,28,39
Dustyn McFaul,Clarkson,3,0,3,-8,25,24,35
Dylan Anhorn,St. Cloud State,6,27,33,14,83,34,38
Dylan Davies,Rensselaer,0,0,0,0,3,2,3
Dylan Duke,Michigan,26,23,49,8,137,30,41
Dylan Finlay,Alaska-Anchorage,1,1,2,-8,20,4,23
Dylan Ghaemi,Stonehill,0,0,0,0,0,0,1
Dylan Gratton,Penn State,3,10,13,1,64,2,36
Dylan Herzog,Yale,0,5,5,4,22,6,28
Dylan Hryckowian,Northeastern,7,27,34,9,93,22,34
Dylan Jackson,Arizona State,7,4,11,-1,43,18,15
Dylan James,North Dakota,9,10,19,11,94,12,40
Dylan Lugris,Penn State,8,6,14,-6,67,4,36
Dylan Meilun,Stonehill,0,0,0,0,0,2,25
Dylan Moulton,Miami,6,2,8,-10,37,35,34
Dylan Peterson,Boston University,8,12,20,10,60,73,35
Dylan Robbins,Sacred Heart,0,2,2,-8,17,16,35
Dylan Wendt,Western Michigan,23,21,44,10,88,10,38
Eamon Powell,Boston College,5,33,38,19,52,8,40
Ean Somoza,Western Michigan,0,0,0,-1,11,12,10
Easton Hesse,Lake Superior,0,0,0,0,0,0,8
Easton Zueger,Army,1,2,3,-7,14,4,21
Edvard Nordlund,Mass.-Lowell,0,0,0,0,0,0,2
Edvards Bergmanis,Alaska,0,0,0,0,1,0,2
Elan Bar-Lev-Wise,Yale,1,2,3,0,21,30,28
Eli Barnett,Vermont,0,5,5,6,6,16,24
Eli Pilosof,Union,0,0,0,0,0,2,1
Eli Sebastian,Northeastern,0,1,1,-12,24,2,32
Elijah Gonsalves,RIT,20,18,38,18,106,30,36
Elliott McDermott,Massachusetts,0,2,2,1,27,14,35
Ellis Rickwood,Clarkson,4,5,9,3,26,8,22
Emerson Goode,Ferris State,7,5,12,3,75,24,32
Emmett Croteau,Clarkson,0,0,0,0,0,0,6
Eric Charpentier,Dartmouth,4,7,11,2,40,25,32
Eric Ciccolini,Clarkson,8,8,16,3,83,28,34
Eric Huss,Army,0,1,1,0,16,4,15
Eric Martin,Bemidji State,8,18,26,-5,77,6,38
Eric Parker,Bowling Green,1,8,9,-10,33,29,33
Eric Pohlkamp,Bemidji State,11,13,24,4,123,18,32
Erik Bargholtz,Clarkson,4,5,9,5,30,6,29
Erik Urbank,Canisius,4,9,13,2,52,37,34
Ethan AuCoin,St. Cloud State,4,2,6,1,23,8,19
Ethan Benz,Union,4,1,5,1,15,10,15
Ethan Bono,Merrimack,6,3,9,-2,31,8,29
Ethan Edwards,Michigan,3,7,10,13,39,20,21
Ethan Gauer,St. Thomas,0,12,12,-8,48,26,37
Ethan Haider,Connecticut,0,0,0,0,0,0,21
Ethan Harrison,Bentley,1,0,1,2,10,2,13
Ethan Langenegger,Lake Superior,0,0,0,0,0,0,33
Ethan Leyh,Bentley,13,16,29,11,94,34,35
Ethan Lund,Niagara,2,3,5,-6,27,8,33
Ethan Manderville,Colgate,9,10,19,2,52,10,36
Ethan Mistry,Brown,0,11,11,-12,45,6,30
Ethan Pearson,Princeton,0,1,1,0,0,0,15
Ethan Phillips,Western Michigan,9,14,23,14,62,12,29
Ethan Robertson,Canisius,0,0,0,0,0,0,19
Ethan Scardina,Bowling Green,6,6,12,-4,49,22,26
Ethan Straky,Colorado College,2,3,5,11,42,16,37
Ethan Szmagaj,Arizona State,3,4,7,6,45,29,37
Ethan Ullrick,Air Force,0,0,0,-3,6,15,7
Ethan Zielke,Lindenwood,7,8,15,-9,47,18,28
Evan Bushy,Lake Superior,1,14,15,7,51,18,37
Evan McIntyre,Augustana,3,8,11,-10,31,16,34
Evan Miller,RIT,0,2,2,-1,7,4,10
Evan Mitchell,St. Lawrence,0,0,0,0,0,0,1
Evan Murr,Minnesota State,6,20,26,8,79,14,37
Evan Orr,Michigan Tech,1,1,2,-1,12,2,14
Evan Stella,American Int'l,3,5,8,-3,34,37,40
Evan Szary,Army,0,1,1,0,0,0,26
Evan Werner,Colorado College,6,13,19,-1,85,10,37
Felikss Gavars,St. Lawrence,13,12,25,-9,109,14,39
Felix Trudeau,Maine,3,2,5,1,25,6,24
Filip Fornåå Svensson,Mass.-Lowell,5,4,9,-5,66,6,35
Filip Forsmark,Merrimack,5,13,18,-10,47,25,35
Filip Wiberg,Alaska,1,0,1,0,3,4,3
Finn Brown,Rensselaer,0,1,1,-1,10,0,16
Francis Boisvert,Robert Morris,0,1,1,0,0,0,13
Frank Djurasevic,Merrimack,4,6,10,-2,72,26,35
Frank Ireland,Stonehill,9,9,18,-30,60,21,34
Frank Nazar III,Michigan,17,24,41,-7,104,18,41
Frankie Carogioiello,Miami,2,0,2,0,5,0,4
Freddie Halyk,Denver,0,1,1,0,0,0,13
Gabe Blanchard,Mass.-Lowell,0,1,1,-1,6,19,12
Gabe Carriere,Vermont,0,2,2,0,0,0,34
Gabe Perreault,Boston College,19,41,60,24,91,29,36
Gabriel Lunn,Robert Morris,1,5,6,-16,33,18,29
Gabriel Seger,Cornell,14,30,44,30,60,16,35
Garrett Brown,Denver,0,4,4,6,6,14,8
Garrett Dahm,Mercyhurst,7,21,28,2,65,23,35
Garrett Horsager,Bentley,2,9,11,12,36,12,35
Garrett Pinoniemi,Minnesota,1,2,3,-4,15,2,35
Garrett Pyke,North Dakota,3,22,25,11,63,14,39
Garrett Schifsky,Michigan,16,18,34,17,108,16,41
Garrett Sundquist,Sacred Heart,1,0,1,-3,2,2,9
Garrett Valk,Long Island,2,1,3,0,32,14,35
Gavin Abric,Army,0,0,0,0,0,0,19
Gavin Best,Michigan State,0,0,0,-2,2,0,2
Gavin Brindley,Michigan,25,28,53,17,122,28,40
Gavin Enright,Bemidji State,0,0,0,0,0,0,15
Gavin FitzPatrick,Stonehill,0,0,0,0,0,0,13
Gavin Gulash,Robert Morris,2,7,9,-7,40,35,38
Gavin McCarthy,Boston University,1,4,5,12,29,41,38
Gavin O'Connell,Michigan State,15,11,26,8,74,12,38
Gavin Puskar,Brown,0,0,0,-4,22,6,26
Gentry Shamburger,Boston College,1,1,2,-4,10,8,30
George Fegaras,Cornell,3,4,7,9,57,12,33
George Grannis,Clarkson,2,1,3,-4,23,12,30
George Krotiris,Robert Morris,6,6,12,-8,72,19,36
Gianfranco Cassaro,RIT,18,20,38,21,146,28,40
Gibson Homer,Arizona State,0,0,0,0,0,0,14
Girts Silkalns,Mass.-Lowell,0,2,2,-3,25,6,18
Gleb Veremyev,Colorado College,15,13,28,13,101,55,37
Glebs Prohorenkovs,Niagara,9,12,21,-10,66,21,39
Grady Hobbs,RIT,10,8,18,4,99,16,39
Graham Gamache,Providence,6,8,14,1,68,8,35
Grant Adams,St. Lawrence,0,0,0,0,0,0,2
Grant Ahcan,St. Cloud State,3,5,8,-1,20,15,23
Grant Anderson,Sacred Heart,0,3,3,-5,33,11,34
Grant Docter,St. Thomas,0,7,7,-3,25,8,22
Grant Hindman,Lake Superior,1,4,5,-5,44,8,36
Grant Porter,Canisius,4,3,7,-1,36,4,16
Grant Silianoff,Notre Dame,4,7,11,4,48,12,28
Grant Slukynsky,Northern Michigan,6,3,9,-3,45,6,34
Grayson Arnott,Maine,2,3,5,3,23,6,25
Grayson Constable,Long Island,9,9,18,-3,85,22,35
Grayson Dietrich,American Int'l,2,1,3,-1,19,18,19
Greg Japchen,Stonehill,3,11,14,-28,43,10,28
Greg Lapointe,St. Lawrence,6,2,8,0,52,6,25
Greg Orosz,Alaska-Anchorage,0,0,0,0,0,0,8
Griffin Jurecki,Michigan State,1,1,2,0,8,0,6
Griffin Loughran,Canisius,6,9,15,-6,52,78,21
Griffin Ludtke,Omaha,4,23,27,1,41,27,40
Griffin Ness,North Dakota,3,3,6,0,21,16,30
Guillaume Richard,Providence,3,15,18,5,67,27,35
Gunnar Thoreson,St. Lawrence,2,2,4,5,22,2,27
Gunnar VanDamme,Alaska-Anchorage,3,7,10,7,39,29,34
Gunnarwolfe Fontaine,Northeastern,8,19,27,-2,65,6,36
Gustav Blom,RIT,3,7,10,3,34,20,32
Gustav Stjernberg,Bowling Green,4,7,11,2,55,40,31
Guy Blessing,Air Force,0,0,0,0,0,0,38
Hampus Rydqvist,Miami,1,7,8,-22,59,20,36
Hank Kempf,Cornell,1,7,8,14,34,12,35
Harrison Blaisdell,New Hampshire,11,3,14,5,45,6,32
Harrison Chesney,Northeastern,0,0,0,0,0,0,1
Harrison Israels,Alaska,20,6,26,10,99,14,33
Harrison Rees,Connecticut,3,4,7,-2,47,10,36
Harrison Roy,Lake Superior,8,16,24,-17,112,8,38
Harrison Scott,Maine,15,12,27,6,102,18,37
Harry Meirowitz,Brown,0,0,0,0,1,0,1
Hayden Hennen,Augustana,4,10,14,-8,64,10,32
Heath Armstrong,Long Island,0,1,1,4,4,0,8
Henri Schreifels,Stonehill,8,8,16,-24,72,28,34
Henry Bartle,Michigan Tech,1,4,5,5,10,19,16
Henry Graham,Boston University,0,0,0,0,0,0,2
Henry Nelson,Notre Dame,0,1,1,-2,39,42,31
Henry Wagner,Yale,1,3,4,-5,34,10,30
Henry Welsch,Mass.-Lowell,0,0,0,0,0,0,22
Henry Wilder,Colorado College,0,0,0,0,0,0,3
Hobie Hedquist,North Dakota,0,0,0,0,0,0,7
Holden Doell,Ferris State,1,3,4,-6,27,12,24
Holt Oliphant,Air Force,10,4,14,-6,55,10,38
Hoyt Stanley,Cornell,2,8,10,16,37,22,35
Hudson Lambert,Canisius,1,2,3,-5,20,6,13
Hudson Malinoski,Providence,9,9,18,4,79,29,35
Hudson Schandor,Connecticut,5,16,21,9,66,31,34
Hugh Larkin,Western Michigan,5,4,9,-5,40,34,37
Hugo Ollas,Merrimack,0,0,0,0,0,2,22
Hunter Andrew,Canisius,0,0,0,-8,8,4,16
Hunter Bischoff,Augustana,4,4,8,-5,41,2,26
Hunter Hastings,Stonehill,0,0,0,-21,27,16,32
Hunter Johannes,North Dakota,12,7,19,10,91,29,31
Hunter Jones,American Int'l,0,4,4,1,14,4,14
Hunter Longhi,American Int'l,1,2,3,1,19,0,8
Hunter McCoy,Army,1,4,5,2,29,8,25
Hunter McDonald,Northeastern,1,5,6,3,46,32,23
Hunter Sansbury,Sacred Heart,5,10,15,-16,75,37,36
Hunter Strand,Notre Dame,4,15,19,1,65,2,36
Hunter Weiss,Notre Dame,0,0,0,-1,0,0,1
Huston Karpman,Connecticut,0,0,0,-1,0,0,1
Ian Carpentier,Yale,8,6,14,-5,63,8,26
Ian Devlin,Princeton,0,1,1,0,6,8,12
Ian Moore,Harvard,3,5,8,-6,38,10,21
Ian Murphy,Princeton,11,12,23,1,58,10,25
Ian Pierce,Dartmouth,2,9,11,2,51,8,21
Ian Shane,Cornell,0,0,0,0,0,0,34
Iisai Pesonen,Yale,5,1,6,-11,19,24,30
Iivari Rasanen,Quinnipiac,4,7,11,25,66,16,39
Isaac Gordon,Michigan Tech,18,18,36,8,108,4,40
Isaac Howard,Michigan State,8,28,36,3,111,10,36
Isac Jonsson,Mass.-Lowell,3,9,12,-15,62,2,36
Isack Bandu,Northern Michigan,1,4,5,0,25,45,26
Isaiah Fox,Long Island,13,20,33,4,75,66,35
Isak Posch,St. Cloud State,0,0,0,0,0,0,14
Isak Walther,Vermont,5,7,12,10,36,6,24
Ivan Zivlak,Merrimack,1,2,3,-13,23,4,24
J.D. Metz,St. Thomas,2,2,4,0,16,0,24
J.P. Turner,New Hampshire,4,6,10,1,37,21,24
Jack Agnew,Rensselaer,2,5,7,-10,32,16,37
Jack Anderson,Lindenwood,1,4,5,-14,26,40,28
Jack Babbage,New Hampshire,1,4,5,5,19,0,15
Jack Bar,Harvard,1,5,6,-9,29,12,27
Jack Blake,Bowling Green,0,1,1,-4,13,4,23
Jack Blanchett,Lake Superior,2,2,4,2,15,8,12
Jack Brackett,Rensselaer,1,8,9,-2,35,4,33
Jack Budd,Canisius,2,2,4,-5,16,6,15
Jack Clement,Miami,1,7,8,-13,40,10,36
Jack Collins,Mass.-Lowell,3,2,5,-3,25,4,20
Jack Cronin,Princeton,11,8,19,-11,64,8,26
Jack Devine,Denver,27,29,56,29,142,20,44
Jack Harvey,Boston University,7,8,15,14,50,4,20
Jack Horbach,Wisconsin,6,8,14,15,47,26,38
Jack Hughes,Boston University,7,12,19,10,65,12,38
Jack Jensen,Augustana,4,4,8,-4,30,23,15
Jack Judson,Clarkson,0,7,7,3,35,57,35
Jack Lyons,Canisius,1,1,2,-5,24,10,26
Jack Malinski,Vermont,2,4,6,3,33,16,26
Jack Malone,Boston College,12,13,25,7,73,12,41
Jack Mesic,Ferris State,2,8,10,0,67,8,36
Jack Millar,Colorado College,4,8,12,-1,60,24,37
Jack Musa,Massachusetts,12,17,29,9,76,6,37
Jack O'Brien,Cornell,0,0,0,4,5,0,9
Jack O'Leary,Cornell,7,8,15,15,43,12,35
Jack Pascucci,Connecticut,0,0,0,-8,15,6,24
Jack Peart,St. Cloud State,3,11,14,-4,65,18,38
Jack Perbix,Northern Michigan,1,3,4,-8,34,35,31
Jack Powell,Bemidji State,0,0,0,1,0,0,4
Jack Quinn,Long Island,2,6,8,5,32,31,32
Jack Randl,Omaha,13,13,26,5,106,10,39
Jack Reimann,St. Cloud State,1,2,3,-5,36,12,25
Jack Richard,Niagara,10,11,21,-5,53,33,34
Jack Ricketts,Holy Cross,19,16,35,18,127,78,39
Jack Robilotti,Holy Cross,3,6,9,11,33,35,35
Jack Rogers,St. Cloud State,4,2,6,-4,25,22,29
Jack Seymour,Holy Cross,5,10,15,5,49,25,37
Jack Shemligian,Stonehill,0,0,0,-5,1,2,4
Jack Smith,Minnesota-Duluth,3,9,12,0,29,12,34
Jack Stark,Yale,0,0,0,0,0,0,21
Jack Stockfish,Holy Cross,9,16,25,2,70,10,32
Jack Watson,Rensselaer,0,0,0,0,0,0,23
Jack Williams,Northeastern,17,19,36,0,86,8,34
Jack Williams,Notre Dame,0,0,0,0,0,0,1
Jack Works,Michigan Tech,10,10,20,2,108,17,35
Jackson Blake,North Dakota,22,38,60,13,129,26,40
Jackson Decker,Canisius,7,10,17,-2,67,28,35
Jackson Dorrington,Northeastern,6,6,12,15,49,6,33
Jackson Hallum,Michigan,3,5,8,6,16,0,9
Jackson Irving,Massachusetts,0,0,0,0,0,0,1
Jackson Jutting,Bemidji State,10,12,22,12,56,2,27
Jackson Kunz,North Dakota,9,10,19,6,45,4,37
Jackson Munro,Brown,2,4,6,-13,20,10,18
Jackson Niedermayer,Arizona State,9,4,13,13,62,10,33
Jackson Nieuwendyk,Canisius,2,5,7,0,33,16,34
Jackson Reineke,Robert Morris,9,12,21,-5,71,43,37
Jacob Badal,Ferris State,0,0,0,-3,3,0,5
Jacob Bauer,Western Michigan,0,4,4,0,20,8,27
Jacob Bengtsson,Boston College,3,11,14,21,29,18,40
Jacob Dirks,Ferris State,3,4,7,-3,29,2,27
Jacob Fowler,Boston College,0,2,2,0,0,0,39
Jacob Guevin,Omaha,3,10,13,-9,61,20,40
Jacob Jeannette,Union,0,7,7,4,28,37,33
Jacob Marti,Air Force,1,1,2,-3,9,21,15
Jacob Napier,Western Michigan,0,1,1,0,2,2,6
Jacob Quillan,Quinnipiac,17,29,46,16,116,16,39
Jacob Slipec,Omaha,2,2,4,1,17,6,30
Jacob Truscott,Michigan,2,14,16,5,62,41,41
Jacques Bouquot,Penn State,12,15,27,-7,79,22,34
Jaden Grant,Bowling Green,3,11,14,-4,43,14,36
Jaeden Mercier,Lindenwood,3,8,11,-12,39,6,28
Jaedon Leslie,Niagara,0,1,1,-7,21,8,14
Jaiden Moriello,Mass.-Lowell,0,5,5,-1,18,6,16
Jak Vaarwerk,Mass.-Lowell,5,10,15,-1,49,28,36
Jake Barczewski,Michigan,0,1,1,0,0,0,37
Jake Beaune,Mercyhurst,2,6,8,4,46,33,35
Jake Black,Connecticut,2,2,4,-2,31,2,24
Jake Boltmann,Notre Dame,0,2,2,-2,32,22,30
Jake Bongo,Sacred Heart,3,7,10,2,52,4,36
Jake Braccini,St. Thomas,4,5,9,-8,53,8,24
Jake Cady,Stonehill,3,3,6,-22,25,25,24
Jake Dunlap,Ohio State,3,5,8,-8,54,40,33
Jake Felker,Army,0,0,0,-7,11,19,14
Jake Flynn,Connecticut,1,5,6,-5,53,10,33
Jake Gagnon,Rensselaer,8,6,14,-10,60,8,30
Jake Hewitt,Army,7,10,17,-5,56,6,35
Jake Higgins,Holy Cross,5,4,9,2,53,17,31
Jake Kraft,Cornell,4,9,13,6,47,2,34
Jake LaRusso,Stonehill,3,2,5,-26,22,10,18
Jake Lammens,St. Lawrence,0,1,1,-5,1,4,7
Jake Livanavage,North Dakota,5,24,29,5,56,6,40
Jake Martin,Quinnipiac,0,1,1,3,7,0,25
Jake McLean,Bemidji State,6,4,10,1,24,2,38
Jake Percival,Connecticut,7,7,14,5,62,18,36
Jake Ratzlaff,St. Thomas,0,1,1,-3,12,2,14
Jake Richard,Connecticut,7,11,18,1,62,6,36
Jake Sacratini,American Int'l,0,0,0,0,0,0,2
Jake Schmaltz,North Dakota,1,10,11,3,49,13,36
Jake Schneider,Colgate,9,9,18,8,77,12,35
Jake Sibell,St. Thomas,0,1,1,0,0,0,15
Jake Southgate,Lindenwood,7,9,16,-3,44,6,28
Jake Stella,Mass.-Lowell,3,6,9,-15,36,12,29
Jake Veilleux,Connecticut,0,0,0,0,1,0,11
Jakob Hellsten,New Hampshire,0,0,0,0,0,0,28
Jakob Lee,Rensselaer,7,4,11,-3,57,41,23
Jakob Peterson,Northern Michigan,0,1,1,-3,15,2,18
Jakob Stender,Minnesota State,0,4,4,1,14,4,27
Jakub Lewandowski,Bemidji State,1,1,2,-3,7,4,9
James Callahan,Air Force,0,0,0,0,0,0,2
James Crossman,Michigan State,0,0,0,0,4,0,5
James Gray,St. Cloud State,0,0,0,0,0,0,1
James Marooney,St. Thomas,0,5,5,5,29,6,15
Jamie Armstrong,Boston College,5,7,12,4,34,17,32
Jamie Engelbert,Providence,7,4,11,3,44,16,28
Jan Korec,Boston College,0,0,0,0,0,0,4
Jan Lasak,St. Lawrence,6,7,13,-3,48,2,35
Jan Olenginski,St. Lawrence,3,2,5,-3,30,8,23
Jared Westcott,Lake Superior,18,18,36,7,101,51,38
Jared Whale,Alaska-Anchorage,0,0,0,0,0,0,25
Jared Wright,Denver,15,10,25,5,73,8,44
Jarod Crespo,Penn State,3,5,8,-9,45,24,35
Jaroslav Chmelar,Providence,5,10,15,7,53,29,26
Jarred White,Alaska-Anchorage,0,6,6,2,34,12,24
Jarrett Fiske,Niagara,0,3,3,0,0,0,29
Jaryd Sych,Mercyhurst,0,0,0,-1,3,0,3
Jase Sofo,St. Thomas,1,0,1,-2,12,14,18
Jason Brancheau,Ferris State,9,7,16,-9,60,16,35
Jason Grande,Holy Cross,0,0,0,0,0,0,22
Jason Siedem,New Hampshire,1,0,1,-2,3,0,8
Jasper Lester,Air Force,0,0,0,1,4,0,2
Jaxon Nelson,Minnesota,19,12,31,14,106,6,39
Jaxson Ezman,Princeton,4,3,7,2,31,4,15
Jay Ahearn,Niagara,10,16,26,-6,101,26,34
Jayden Davis,Notre Dame,2,1,3,-2,12,19,21
Jayden Lee,Quinnipiac,3,23,26,20,66,8,39
Jayden Perron,North Dakota,11,7,18,-1,98,8,39
Jayden Sison,Princeton,0,4,4,-5,25,19,30
Jed Pietila,Michigan Tech,2,12,14,7,51,26,40
Jeff Hutchinson,Augustana,0,1,1,0,16,6,21
Jens Richards,Vermont,10,11,21,3,90,10,32
Jeppe Urup,Northern Michigan,0,0,0,-3,3,2,8
Jere Vaisanen,Bemidji State,9,8,17,2,72,4,37
Jeremie Bucheler,Vermont,6,12,18,-3,57,27,33
Jeremie Payant,Rensselaer,2,2,4,-1,22,10,19
Jeremy Davidson,Michigan State,12,10,22,9,66,28,38
Jeremy Forman,New Hampshire,0,0,0,0,0,0,1
Jeremy Gervais,Lake Superior,0,0,0,-1,2,0,2
Jeremy Wilmer,Boston University,6,30,36,16,45,19,38
Jesse Lansdell,Omaha,3,12,15,1,36,74,39
Jesse Tucker,Clarkson,4,10,14,4,30,28,34
Jimmy Clark,Minnesota,5,6,11,5,59,4,39
"Jimmy Dowd, Jr.",Penn State,2,11,13,-1,54,26,28
Jimmy Doyle,Bentley,0,5,5,-5,45,16,25
Jimmy Glynn,Omaha,9,6,15,-11,43,14,39
Jimmy Goffredo,Rensselaer,3,3,6,-2,34,19,22
Jimmy Snuggerud,Minnesota,21,13,34,3,182,42,39
JoJo Tanaka-Campbell,Yale,1,1,2,-4,6,2,11
Joaquim Lemay,Omaha,5,13,18,-3,66,18,37
Joe Berg,Princeton,2,2,4,-13,18,6,30
Joe Cassetti,Western Michigan,8,9,17,-2,79,8,38
Joe Dunlap,Ohio State,3,5,8,2,24,25,13
Joe Miller,Harvard,13,14,27,-5,67,8,32
Joe Molenaar,St. Cloud State,8,4,12,4,69,19,32
Joe Palodichuk,Wisconsin,3,15,18,13,64,25,40
Joe Prouty,Lindenwood,0,6,6,-14,34,75,28
Joe Sharib,Union,0,0,0,0,0,0,4
Joe Solimine,Holy Cross,3,3,6,1,21,26,32
Joel Maatta,Vermont,4,5,9,-6,31,35,26
Joey Baez,Army,15,16,31,-10,92,14,32
Joey Dosan,Army,0,0,0,-1,1,0,2
Joey Lamoreaux,Alaska-Anchorage,0,2,2,0,0,2,9
Joey Larson,Michigan State,16,16,32,6,131,8,38
Joey Muldowney,Connecticut,5,9,14,-7,74,12,35
Joey Musa,Dartmouth,6,11,17,0,58,18,32
Joey Pierce,Minnesota-Duluth,0,5,5,-1,39,12,35
Joey Potter,Union,0,3,3,-1,28,4,21
John Beaton,Rensselaer,4,8,12,-22,39,2,32
John Dalton,Maine,0,0,0,-2,2,0,8
John Driscoll,Army,5,16,21,-18,52,16,35
John Evans,Rensselaer,4,6,10,-3,16,2,16
John Fusco,Dartmouth,7,10,17,-6,69,19,32
John Gelatt,Holy Cross,6,7,13,-7,70,20,38
John Gormley,Long Island,1,3,4,7,31,61,35
John Herrington,Lake Superior,9,11,20,-5,88,12,37
John Jaworski,Sacred Heart,10,16,26,-8,86,14,35
John Larkin,Ohio State,1,0,1,2,5,2,3
John Lundy,American Int'l,14,8,22,9,54,25,26
John Mittelstadt,Minnesota,1,1,2,0,23,6,33
John Prokop,Union,8,27,35,-8,73,43,36
John Spetz,Connecticut,2,4,6,-12,51,18,36
John Waldron,Miami,9,13,22,-15,88,6,36
Johnny Wescoe,Niagara,4,1,5,-3,21,6,19
Jon Bell,Army,0,0,0,-4,15,15,18
Jon Mor,Michigan State,0,0,0,0,0,0,1
Jonathan Bendorf,Bentley,3,3,6,-6,39,14,26
Jonathan Castagna,Cornell,11,14,25,20,60,25,35
Jonathan Horn,Mass.-Lowell,0,1,1,-1,0,0,5
Jonathan Ziskie,Niagara,2,6,8,-1,27,2,27
Jonny Sorenson,Alaska,8,7,15,2,68,33,33
Jordan Biro,American Int'l,7,16,23,1,82,4,39
Jordan Di Cicco,Long Island,2,5,7,-3,28,4,31
Jordan Power,Minnesota State,1,6,7,1,24,26,31
Jordan Steinmetz,Minnesota State,2,9,11,1,30,10,32
Jordan Tonelli,Brown,3,4,7,-9,36,8,16
Jordan Venegoni,Lake Superior,0,1,1,-3,18,8,18
Josef Mysak,Niagara,2,10,12,-6,48,28,37
Joseph Grainda,Stonehill,3,4,7,-15,25,10,21
Joseph Messina,Union,1,3,4,4,16,10,22
Josh Barnes,American Int'l,3,2,5,-7,39,2,22
Josh Bohlin,Army,0,0,0,-1,1,2,1
Josh Boyer,St. Lawrence,3,6,9,-5,49,23,37
Josh Eernisse,Michigan,8,6,14,-5,85,45,41
Josh Groll,Minnesota State,7,13,20,1,69,15,34
Josh Kotai,Augustana,0,0,0,0,0,0,13
Josh Latta,Bentley,2,8,10,-2,27,25,28
Josh Luedtke,St. Cloud State,4,13,17,2,62,21,37
Josh Nadeau,Maine,18,27,45,14,110,12,37
Josh Niedermayer,Arizona State,0,4,4,1,11,2,19
Josh Nixon,Union,9,18,27,-6,70,33,36
Josh Nodler,Bowling Green,5,10,15,-22,73,8,36
Josh Orrico,Michigan,0,0,0,0,1,2,7
Josh Phillips,Union,0,0,0,0,2,2,2
Josh Waters,Dartmouth,0,1,1,-4,14,16,24
Josh Zary,Long Island,19,13,32,6,82,17,33
Josh Zinger,Northern Michigan,3,17,20,-11,58,20,34
Joshua Karnish,Princeton,3,1,4,-13,30,28,27
Joshua Wildauer,Lake Superior,0,5,5,-3,10,4,15
Jude Brower,Army,0,4,4,-2,19,7,15
Julius Janhonen,American Int'l,5,19,24,-2,81,27,40
Justen Close,Minnesota,0,4,4,0,0,0,38
Justin Barker,Stonehill,4,3,7,-13,50,10,23
Justin Hryckowian,Northeastern,13,30,43,24,87,8,32
Justin Janicke,Notre Dame,4,12,16,-2,59,47,36
Justin Paul,St. Lawrence,7,12,19,-14,85,10,37
Justin Robbins,Sacred Heart,0,0,0,0,0,0,17
Kabore Dunn,Lindenwood,0,11,11,-6,21,20,22
Kade Nielsen,Minnesota State,0,0,0,-4,10,0,8
Kade Peterson,Long Island,0,0,0,-2,7,4,9
Kaden Bohlsen,Minnesota State,11,10,21,6,68,52,37
Kaelan Taylor,Clarkson,1,5,6,2,27,28,34
Kai Daniells,Princeton,8,11,19,-11,78,14,30
Kaidan Mbereko,Colorado College,0,0,0,0,0,0,37
Kaleb Ergang,Ferris State,6,9,15,-8,51,10,34
Kaleb Johnson,North Dakota,0,0,0,0,0,0,1
Kaleb Tiessen,St. Cloud State,0,0,0,1,3,0,6
Kalen Szeto,Yale,2,2,4,-9,39,23,27
Karl Falk,St. Cloud State,0,2,2,-7,31,6,33
Karsen Dorwart,Michigan State,15,19,34,8,116,28,38
Karter McNarland,Alaska-Anchorage,3,5,8,3,21,6,16
Kash Rasmussen,Michigan Tech,3,9,12,4,52,9,35
Kasper Magnussen,Bemidji State,7,4,11,3,45,6,29
Kasper Vaharautio,Michigan Tech,0,2,2,5,31,12,37
Kayden Hargraves,Augustana,0,0,0,0,0,0,9
Keanan Stewart,Mercyhurst,10,5,15,-6,53,10,31
Keaton Pehrson,North Dakota,0,8,8,5,25,10,35
Keegan Langefels,Canisius,0,0,0,-4,4,2,7
Keenan Rancier,Minnesota State,0,0,0,0,0,0,12
Kellan Hjartarson,Bentley,8,9,17,7,77,16,34
Kennedy O'Connor,Massachusetts,0,0,0,0,0,0,1
Kenny Connors,Massachusetts,7,15,22,-2,77,14,37
Kent Anderson,Denver,3,4,7,11,24,12,41
Kevin Anderson,Princeton,1,0,1,-5,9,4,17
Kevin Lombardi,Sacred Heart,11,14,25,-10,102,19,36
Kevin Marx Noren,Northern Michigan,4,13,17,-2,73,14,30
Kevin Scott,RIT,0,3,3,3,23,19,29
Kienan Draper,Michigan,4,8,12,4,35,24,37
Kieran Cebrian,Denver,3,10,13,12,39,14,36
Kieran O'Hearn,Yale,0,1,1,-10,16,36,29
Kieran Ruscheinski,Lindenwood,1,3,4,2,7,15,17
Killian Kiecker-Olson,Canisius,2,3,5,-6,27,15,21
Kirby Proctor,Omaha,7,8,15,8,41,8,40
Kirklan Irey,Bemidji State,8,7,15,4,60,22,37
Klavs Veinbergs,Colorado College,4,6,10,0,28,10,19
Kolby Amici,Bentley,2,0,2,-2,11,6,14
Kristaps Skrastins,New Hampshire,5,7,12,3,67,4,35
Kristof Papp,Northern Michigan,6,13,19,-3,63,6,34
Kristoffer Eberly,Ohio State,0,0,0,0,0,0,14
Kyle Aucoin,Harvard,0,1,1,-4,7,6,8
Kyle Bettens,Minnesota-Duluth,6,12,18,1,41,14,36
Kyle Chauvette,Union,0,0,0,0,0,0,36
Kyle Gaffney,Alaska,2,8,10,1,57,16,34
Kyle Haskins,Canisius,4,11,15,-6,85,10,35
Kyle Heath,Stonehill,1,6,7,-28,23,8,33
Kyle Jeffers,Lindenwood,9,8,17,-6,42,4,26
Kyle Kukkonen,Michigan Tech,1,11,12,-4,71,18,27
Kyle Looft,Bemidji State,6,22,28,17,69,14,32
Kyle McClellan,Wisconsin,0,0,0,0,0,0,37
Kyle Penney,Cornell,10,18,28,30,66,18,35
Kyle Smolen,Arizona State,7,9,16,3,33,59,36
Kyler Head,Mercyhurst,6,9,15,-14,49,36,30
Kyler Kleven,Minnesota-Duluth,1,2,3,0,11,13,25
Kyler Kovich,Cornell,0,1,1,1,7,2,7
Kyler Kupka,St. Cloud State,14,18,32,8,79,18,38
Lachlan Getz,Michigan Tech,1,2,3,-3,30,8,28
Landon Slaggert,Notre Dame,20,11,31,8,92,10,36
Lane Brockhoff,Niagara,2,6,8,2,49,54,37
Lane Hutson,Boston University,15,34,49,14,109,24,38
Lars Rodne,Niagara,8,12,20,-9,74,4,34
Lassi Lehti,Alaska,0,0,0,0,0,0,7
Lauri Raiman,Michigan Tech,2,2,4,-13,40,4,32
Lauri Sertti,Rensselaer,2,6,8,-16,36,16,36
Lawton Zacher,Brown,0,1,1,0,0,0,26
Lee Chiang,Robert Morris,0,0,0,-1,5,0,3
Levi Glasman,Colgate,1,5,6,0,26,6,33
Levi Stauber,Michigan Tech,1,1,2,1,14,4,20
Liam Dennison,Merrimack,2,7,9,-6,26,10,35
Liam Devlin,New Hampshire,13,7,20,6,67,37,28
Liam Engstrom,Bemidji State,3,2,5,-2,26,4,17
Liam Gorman,Massachusetts,1,3,4,2,29,17,28
Liam Izyk,Sacred Heart,4,4,8,-4,36,33,34
Liam Lesakowski,Maine,0,2,2,0,29,36,34
Liam Malmquist,St. Thomas,10,17,27,-7,91,10,36
Liam McLinskey,Holy Cross,19,28,47,23,113,32,39
Liam Robertson,Union,10,13,23,-6,39,20,34
Liam Souliere,Penn State,0,0,0,0,0,0,28
Liam Valente,Providence,4,5,9,2,47,10,29
Liam Walsh,Northeastern,4,3,7,-13,34,28,36
Linden Alger,Massachusetts,2,2,4,5,32,4,35
Lleyton Roed,Bemidji State,14,16,30,4,101,16,38
Logan Acheson,Bemidji State,2,2,4,0,23,4,28
Logan Britt,North Dakota,7,7,14,13,46,10,40
Logan Ganie,Robert Morris,6,9,15,-13,66,6,35
Logan Jenuwine,American Int'l,1,6,7,-10,44,12,23
Logan Neaton,Miami,0,0,0,0,0,2,23
Logan Pietila,Michigan Tech,13,16,29,-2,108,4,40
Logan Ritchie,St. Lawrence,1,3,4,-13,33,4,28
Logan Stein,Ferris State,0,0,0,0,0,0,21
Logan Terness,Ohio State,0,0,0,0,0,0,27
Logan Will,Colorado College,7,11,18,6,86,12,37
Louis Jamernik V,North Dakota,8,9,17,3,60,18,40
Luc Laylin,St. Thomas,9,6,15,-11,76,6,37
Luc Salem,St. Lawrence,3,5,8,-8,76,30,38
Luc Wilson,Minnesota State,7,12,19,-2,75,14,36
Luca Di Pasquo,Michigan State,0,0,0,0,0,0,4
Luca Fantilli,Michigan,1,7,8,12,20,8,38
Luca Münzenberger,Vermont,1,2,3,2,29,51,32
Lucas Coon,Air Force,3,2,5,2,13,2,11
Lucas Jones,Vermont,0,0,0,-2,0,17,6
Lucas Kanta,Army,1,2,3,-4,42,8,28
Lucas Matta,Rensselaer,1,1,2,-12,13,12,32
Lucas Mercuri,Massachusetts,9,16,25,1,58,29,37
Lucas Olvestad,Denver,0,6,6,8,17,14,32
Lucas Sowder,Minnesota State,13,15,28,1,72,16,33
Lucas Thorne,Holy Cross,2,6,8,-2,27,20,33
Lucas Vanroboys,Massachusetts,3,5,8,4,38,22,29
Lucas Wahlin,St. Thomas,12,18,30,4,134,48,37
Ludvig Persson,North Dakota,0,3,3,0,0,0,34
Luigi Benincasa,Ferris State,6,16,22,1,64,6,33
Luis Lindner,New Hampshire,0,10,10,3,42,2,36
Lukas Gustafsson,Boston College,3,13,16,17,67,22,41
Lukas Sillinger,Arizona State,11,37,48,1,90,10,38
Luke Antonacci,Maine,0,5,5,16,28,10,37
Luke Bast,Minnesota-Duluth,2,7,9,2,45,39,37
Luke Devlin,Cornell,6,2,8,1,29,12,28
Luke Erickson,St. Lawrence,0,0,0,-4,6,10,14
Luke Farthing,Canisius,0,4,4,2,20,6,15
Luke Grainger,Western Michigan,14,34,48,10,76,21,38
Luke Haymes,Dartmouth,18,18,36,2,84,12,31
Luke Johnson,Minnesota-Duluth,1,2,3,-3,13,12,26
Luke Johnson,Robert Morris,2,11,13,-22,41,10,39
Luke Khozozian,Harvard,0,0,0,-1,5,19,12
Luke Krys,Providence,6,11,17,2,92,16,35
Luke LaMaster,Wisconsin,0,0,0,0,0,0,1
Luke Levandowski,Lake Superior,2,6,8,5,34,4,29
Luke Loheit,Minnesota-Duluth,10,10,20,-8,64,53,36
Luke Lush,RIT,0,0,0,0,0,0,4
Luke Manning,St. Thomas,7,6,13,-4,89,14,37
Luke Mittelstadt,Minnesota,2,18,20,11,57,14,38
Luke Mobley,Augustana,12,7,19,-5,63,23,34
Luke Mylymok,Niagara,9,7,16,-10,64,20,38
Luke Pavicich,Mass.-Lowell,0,1,1,0,0,0,17
Luke Reid,New Hampshire,1,15,16,5,59,18,36
Luke Robinson,Air Force,2,7,9,6,46,32,38
Luke Rowe,Air Force,6,23,29,-10,98,70,35
Luke Tuch,Boston University,10,20,30,17,95,10,39
Luke Weilandt,Merrimack,3,2,5,-2,18,6,23
Luke van Why,Robert Morris,2,2,4,4,31,8,18
Lynden Breen,Maine,9,21,30,17,109,20,37
Lynden Grandberg,Brown,0,0,0,-4,9,0,18
Mac Gadowsky,Army,4,19,23,-1,60,8,28
Mac Welsher,Merrimack,4,9,13,2,48,18,30
Mack Byers,St. Thomas,13,8,21,9,61,4,31
Mack Oliphant,Holy Cross,2,8,10,2,59,19,38
Mackenzie Merriman,Princeton,0,0,0,-15,18,2,27
Macklin Celebrini,Boston University,32,32,64,25,179,18,38
Maddox Fleming,Notre Dame,3,9,12,-7,40,8,35
Maiszon Balboa,Air Force,0,0,0,0,0,0,4
Marcus Brännman,Providence,0,0,0,0,0,2,2
Marcus Joughin,Sacred Heart,8,13,21,-8,47,16,34
Marcus Pedersen,Michigan Tech,5,4,9,-2,34,2,37
Marek Hejduk,Harvard,5,2,7,-19,55,29,32
Marian Mosko,Cornell,0,1,1,3,2,0,11
Mario Gasparini,Vermont,1,0,1,-4,3,4,11
Mark Cheremeta,Sacred Heart,1,10,11,-5,49,6,17
Mark Cooper,Mass.-Lowell,1,3,4,0,25,6,23
Mark Estapa,Michigan,5,4,9,-4,60,46,36
Mark Gallant,Merrimack,2,3,5,-1,35,23,33
Mark Hillier,Merrimack,7,12,19,-7,46,2,35
Marko Reifenberger,Mercyhurst,5,6,11,-10,38,37,33
Marshall Warren,Michigan,4,14,18,0,79,30,41
Marty Lavins,New Hampshire,5,9,14,5,65,28,35
Mason Klee,Ohio State,1,4,5,-5,45,25,38
Mason Kucenski,St. Lawrence,0,0,0,0,0,0,2
Mason Langenbrunner,Harvard,0,5,5,-4,31,8,32
Mason Marcellus,Quinnipiac,14,22,36,34,69,18,39
Mason McCormick,Air Force,6,9,15,-7,84,44,38
Mason Nevers,Minnesota,3,12,15,16,34,12,35
Mason Poolman,St. Thomas,2,6,8,-1,34,16,28
Mason Reiners,St. Cloud State,0,3,3,6,17,4,26
Mason Salquist,St. Cloud State,7,12,19,5,66,27,35
Mason Waite,St. Lawrence,4,16,20,-16,75,14,39
Mason Wheeler,Minnesota State,1,4,5,5,24,18,37
Massimo Lombardi,Vermont,5,7,12,3,47,17,32
Massimo Rizzo,Denver,10,34,44,24,84,10,30
Matej Marinov,Quinnipiac,0,0,0,0,0,0,11
Mateo Dixon,Vermont,2,2,4,1,16,2,18
Mathieu Caron,Boston University,0,0,0,0,0,2,40
Mathieu De St. Phalle,Wisconsin,11,16,27,4,103,8,38
Mathieu Gosselin,Clarkson,11,17,28,3,64,35,31
Matt Allen,Alaska-Anchorage,6,7,13,1,63,4,30
Matt Allen,Stonehill,3,1,4,-24,19,25,22
Matt Basgall,Michigan State,1,15,16,-3,57,2,38
Matt Cassidy,Ohio State,0,0,0,-5,30,24,24
Matt Choupani,Northeastern,3,9,12,-1,53,8,28
Matt Copponi,Merrimack,7,25,32,4,66,48,30
Matt Crasa,Mass.-Lowell,8,5,13,-3,69,16,34
Matt Davis,Denver,0,3,3,0,0,0,31
Matt DeBoer,Holy Cross,4,15,19,-5,82,65,39
Matt DeMelis,Northeastern,2,6,8,-4,20,0,23
Matt DiMarsico,Penn State,7,19,26,-12,90,18,35
Matt Fusco,Dartmouth,3,8,11,-6,46,10,28
Matt Guerra,Holy Cross,8,17,25,-4,92,51,38
Matt Hubbarde,Providence,1,0,1,3,7,2,13
Matt Hutton,Robert Morris,0,0,0,-1,3,2,3
Matt Johnson,Alaska-Anchorage,6,3,9,-1,21,2,14
Matt Kinash,Alaska-Anchorage,2,4,6,4,18,6,18
Matt Koethe,Alaska,3,10,13,6,45,10,31
Matt Miller,Omaha,7,13,20,-16,64,19,37
Matt Pasquale,Connecticut,0,0,0,0,0,0,1
Matt Rickard,American Int'l,2,4,6,-1,27,8,25
Matt Shatsky,Holy Cross,2,19,21,13,47,28,37
Matt Sutton,Brown,3,5,8,-9,34,14,24
Matt Thomson,Bentley,2,2,4,0,26,8,12
Matt Vermaeten,Canisius,7,5,12,0,64,20,30
Matteo Costantini,Western Michigan,11,20,31,20,67,18,38
Matteo Giampa,Canisius,18,17,35,6,101,8,36
Matteo Pecchia,Alaska,0,0,0,-1,1,2,1
Matthew Barbolini,Miami,11,14,25,-4,78,40,31
Matthew Boczar,Robert Morris,1,1,2,-3,7,0,11
Matthew Brille,Brown,0,1,1,-1,6,0,11
Matthew Campbell,Michigan Tech,4,7,11,-6,70,8,30
Matthew Gleason,St. Thomas,5,18,23,2,74,26,37
Matthew Kopperud,Arizona State,23,13,36,-5,123,45,38
Matthew McGroarty,Quinnipiac,1,5,6,7,23,10,22
Matthew Morden,Harvard,1,2,3,-6,33,12,32
Matthew Perkins,Minnesota-Duluth,6,9,15,-12,44,12,35
Matthew Romer,Arizona State,0,1,1,1,7,0,7
Matthew Staudacher,Northeastern,2,2,4,-9,21,8,31
Matthew Syverson,Lindenwood,0,0,0,0,0,0,7
Matthew Thiessen,Minnesota-Duluth,0,1,1,0,0,0,18
Matthew Wilde,RIT,19,16,35,13,129,16,40
Matthew Wood,Connecticut,16,12,28,-1,128,43,35
Mattias Sholl,Bemidji State,0,0,0,0,0,0,24
Matvei Kabanov,Northern Michigan,4,5,9,-3,32,4,26
Max Burkholder,Colorado College,7,9,16,6,67,6,37
Max Dorrington,St. Lawrence,2,5,7,-8,57,29,35
Max Dukovac,Miami,3,7,10,-14,56,10,36
Max Itagaki,Army,6,19,25,-13,57,31,34
Max Koskipirtti,Michigan Tech,4,17,21,4,59,10,33
Max Kouznetsov,Canisius,8,15,23,-1,63,39,36
Max Lacroix,Boston University,0,0,0,0,0,0,1
Max Miller,Harvard,0,0,0,0,0,0,1
Max Montes,Ohio State,9,9,18,-2,71,17,37
Max Osborne,Alaska-Anchorage,0,1,1,1,4,4,11
Max Pineo,Stonehill,3,2,5,-33,24,10,28
Max Rud,Minnesota,0,0,0,-1,3,0,20
Max Ruoho,Niagara,0,1,1,-5,11,2,11
Max Scott,Brown,7,11,18,2,64,12,22
Max Smolinski,Rensselaer,2,11,13,-6,55,50,37
Max Vayrynen,Michigan Tech,0,0,0,0,0,0,4
Max Wattvil,Merrimack,2,1,3,2,26,14,24
Maxim Štrbák,Michigan State,2,7,9,7,37,17,32
Maximilion Helgeson,Alaska-Anchorage,14,13,27,7,97,31,33
McKade Webster,Denver,14,18,32,31,80,54,43
McKay Hayes,Robert Morris,6,8,14,-4,57,35,38
Michael Abgrall,Omaha,0,3,3,2,13,10,12
Michael Bevilacqua,Bowling Green,2,5,7,0,17,2,20
Michael Callow,Harvard,3,12,15,1,45,0,32
Michael Cameron,Massachusetts,6,4,10,-3,39,0,35
Michael Citara,Merrimack,6,9,15,-2,62,6,31
Michael Colella,Northern Michigan,7,5,12,-7,58,6,34
Michael Craig,Robert Morris,0,10,10,-6,41,8,39
Michael Emerson,North Dakota,0,0,0,-1,0,2,6
Michael Feenstra,Miami,0,4,4,0,21,2,18
Michael Fisher,Northeastern,1,1,2,-9,26,14,29
Michael Gildon,Ohio State,5,5,10,3,60,27,34
Michael Hodge,Holy Cross,0,4,4,2,27,18,33
Michael Hrabal,Massachusetts,0,0,0,0,0,0,30
Michael Martignetti,Stonehill,0,0,0,-5,0,4,4
Michael Mastrodomenico,Notre Dame,1,6,7,-4,61,25,33
Michael Mesic,Northern Michigan,4,5,9,-8,41,8,26
Michael Morelli,Michigan Tech,0,0,0,0,0,0,1
Michael Outzen,Northeastern,0,0,0,0,5,2,16
Michael Sacco,Army,6,16,22,-22,81,54,34
Michael Sochan,Robert Morris,0,0,0,0,0,0,2
Michael Suda,Cornell,0,5,5,13,46,10,32
Michael Van Unen,Northern Michigan,1,3,4,-3,21,8,17
Michael Young,Princeton,1,1,2,-1,11,2,7
Mick Frechette,Boston University,0,2,2,2,3,2,7
Mickey Burns,Mercyhurst,5,13,18,-7,80,14,35
Mike Cataldo,Brown,2,1,3,-11,22,8,26
Mike Kennedy,Princeton,2,3,5,-16,39,47,30
Mike Koster,Minnesota,2,12,14,1,50,4,33
Mike Posma,Boston College,2,6,8,10,48,23,41
Mike Vorlicky,Wisconsin,1,4,5,17,31,27,37
Mikey Adamson,Sacred Heart,4,16,20,-8,45,12,34
Mikey Roberts,Dartmouth,0,0,0,0,0,0,1
Miko Matikka,Denver,20,13,33,15,111,41,43
Mitch Allard,Lindenwood,3,4,7,-9,29,39,27
Mitch Andres,Robert Morris,0,4,4,-13,21,35,33
Mitch Deelstra,Northern Michigan,1,2,3,-2,33,8,25
Mitch Lafay,Alaska-Anchorage,0,0,0,0,0,0,1
Mitch Wolfe,Bemidji State,1,12,13,15,45,14,38
Mitchell Becker,Mass.-Lowell,3,3,6,-4,40,12,30
Mitchell Day,Niagara,0,0,0,0,0,0,6
Mitchell Digby,Air Force,2,1,3,-8,23,11,27
Morgan Winters,New Hampshire,10,12,22,3,65,19,33
Nash Nienhuis,Michigan State,9,15,24,20,70,22,38
Nate Benoit,North Dakota,0,1,1,-1,10,4,19
Nate Hanley,Union,4,22,26,-7,99,10,37
Nate Horn,Air Force,3,4,7,-3,46,12,33
Nate Morgan,Dartmouth,1,4,5,-1,14,6,28
Nate Schweitzer,Lake Superior,3,10,13,-3,56,24,38
Nathan Airey,Minnesota,0,0,0,0,0,0,3
Nathan Kelly,Union,1,7,8,0,35,23,35
Nathan McBrayer,Ohio State,0,7,7,1,49,8,34
Nathan Reid,Yale,0,0,0,0,0,0,10
Nathan Sullivan,Rensselaer,0,1,1,-10,11,10,21
Nic Belpedio,Colgate,3,2,5,4,19,2,9
Nic Petruolo,Holy Cross,0,2,2,6,28,39,37
Nicholas Grabko,Bentley,0,0,0,0,0,4,15
Nicholas Kent,Mercyhurst,0,1,1,-6,2,4,16
Nicholas Niemo,Maine,2,2,4,-1,13,4,17
Nicholas Trela,St. Lawrence,2,5,7,-5,26,10,28
Nick Ahern,Vermont,1,5,6,1,30,10,14
Nick Anderson,Colgate,2,19,21,2,59,35,36
Nick Ardanaz,Rensselaer,1,2,3,-9,11,6,18
Nick Bochen,Bentley,6,18,24,15,86,20,35
Nick Cafarelli,New Hampshire,6,5,11,2,35,41,28
Nick Capone,Connecticut,4,4,8,-9,38,46,32
Nick Carabin,Princeton,5,12,17,-2,50,26,27
Nick DeSantis,Cornell,8,6,14,16,46,30,35
Nick Granowicz,Mass.-Lowell,4,4,8,-4,31,10,25
Nick Haas,Colgate,0,0,0,0,0,0,1
Nick Hale,Ferris State,2,6,8,3,50,12,34
Nick Howard,Boston University,0,0,0,0,0,0,1
Nick Marciano,Princeton,2,0,2,-5,16,6,22
Nick Moldenhauer,Michigan,8,13,21,-2,62,2,41
Nick Nardecchia,Ferris State,3,4,7,-16,54,27,34
Nick O'Hanisain,Bowling Green,0,1,1,-1,13,9,20
Nick Poisson,Providence,9,15,24,8,89,16,35
Nick Portz,St. Cloud State,2,2,4,-2,22,14,17
Nick Remissong,Air Force,1,5,6,-3,24,19,34
Nick Rhéaume,Mass.-Lowell,9,4,13,-12,69,32,34
Nick Ring,New Hampshire,2,8,10,-5,44,6,34
Nick Seitz,Princeton,5,18,23,-3,80,14,30
Nick Strom,Rensselaer,0,7,7,-6,38,10,37
Nick Traggio,Brown,3,1,4,2,21,12,26
Nick VanTassell,Massachusetts,1,1,2,-4,15,19,24
Nick Williams,Michigan Tech,1,4,5,8,23,8,25
Nick Young,Union,2,5,7,-2,43,26,37
Nick Zabaneh,Boston University,8,8,16,11,76,36,40
Nicklas Andrews,Colorado College,3,14,17,4,49,29,37
Nicky Wallace,Quinnipiac,0,0,0,1,1,0,2
Nico DeVita,Ferris State,0,0,0,-16,12,2,19
Nico Somerville,American Int'l,4,5,9,11,46,12,40
Nicolas Muller,Michigan State,7,22,29,10,58,22,38
Nik Armstrong-Kingkade,Bentley,7,5,12,2,58,25,24
Nik Hong,Army,7,10,17,-6,57,14,35
Nikita Borodayenko,Merrimack,0,1,1,-1,8,4,12
Nikita Nikora,Dartmouth,3,17,20,-2,44,2,25
Niklas Allain,Yale,6,6,12,0,38,27,28
Niko Rexine,Colgate,2,2,4,-7,22,4,31
Nikolai Jenson,New Hampshire,4,5,9,7,37,12,35
Nils Wallström,American Int'l,0,0,0,0,0,0,33
Noah Altman,Quinnipiac,0,0,0,0,0,0,3
Noah Beck,Clarkson,3,6,9,-17,36,16,30
Noah Carlin,Niagara,3,9,12,3,42,10,27
Noah Ellis,Omaha,0,3,3,-5,11,6,21
Noah Giesbrecht,Ferris State,0,0,0,0,0,0,18
Noah Grannan,Penn State,0,0,0,0,0,0,11
Noah Hackett,Niagara,2,6,8,-6,41,0,29
Noah Kane,Long Island,8,21,29,-3,96,48,32
Noah Laba,Colorado College,20,17,37,20,88,27,36
Noah Prokop,St. Thomas,3,5,8,-3,33,16,27
Noah Quinn,Bemidji State,1,0,1,-3,10,10,18
Noah Rupprecht,Long Island,0,0,0,0,0,0,8
Noah Serdachny,Colorado College,0,0,0,-2,4,2,5
Noah Wakeford,Brown,0,2,2,-3,14,8,23
Noah West,Michigan,0,0,0,0,0,0,7
Noah de la Durantaye,Princeton,3,15,18,-9,60,6,29
Nolan Cunningham,Air Force,0,5,5,-2,27,2,26
Nolan FitzPatrick,Stonehill,1,1,2,-7,5,15,18
Nolan Hayes,Northeastern,0,3,3,-1,13,0,22
Nolan Joyce,Boston College,0,0,0,2,0,0,4
Nolan Krenzen,Omaha,2,8,10,7,27,4,40
Nolan Renwick,Maine,2,9,11,-5,33,14,25
Nolan Sullivan,Omaha,7,9,16,2,71,40,40
Nolan Welsh,Long Island,5,9,14,-1,39,21,31
Oak MacLeod,St. Lawrence,0,0,0,-1,7,2,5
Oliver Bezick,Michigan Tech,0,0,0,-1,0,0,1
Oliver Flynn,Connecticut,1,1,2,-6,18,6,23
Oliver Moberg,Clarkson,0,3,3,-5,12,2,24
Oliver Moore,Minnesota,9,24,33,16,89,8,39
Oliver Tarr,Canisius,7,8,15,2,61,23,37
Olivier Gauthier,Niagara,4,10,14,-9,66,33,39
Ondrej Psenicka,Cornell,9,12,21,13,56,30,35
Oscar Geschwind,American Int'l,2,8,10,9,38,8,32
Oskar Jellvik,Boston College,13,29,42,28,84,16,41
Oskari Vuorio,Dartmouth,0,5,5,-5,22,4,29
Owen Baker,Michigan State,1,1,2,0,8,15,7
Owen Baumgartner,Air Force,4,6,10,1,34,12,24
Owen Bohn,Augustana,6,6,12,1,51,18,31
Owen Cole,Mass.-Lowell,10,7,17,-8,66,8,36
Owen Desilets,Dartmouth,0,4,4,1,15,4,22
Owen Dubois,Air Force,4,2,6,-2,19,6,30
Owen Forester,Yale,0,1,1,-4,17,38,25
Owen Gallatin,Minnesota-Duluth,7,23,30,-17,98,24,37
Owen Lindmark,Wisconsin,11,10,21,17,65,6,28
Owen McLaughlin,North Dakota,13,26,39,11,79,8,39
Owen Mehlenbacher,Wisconsin,1,3,4,4,41,8,26
Owen Michaels,Western Michigan,2,5,7,6,49,10,38
Owen Murray,Massachusetts,2,7,9,-1,34,4,31
Owen Neuharth,Colgate,0,0,0,0,8,4,12
Owen Nolan,Army,0,3,3,-2,19,16,21
Owen Ozar,Bowling Green,5,4,9,-9,59,40,35
Owen Say,Mercyhurst,0,0,0,0,0,2,31
Owen Simpson,Connecticut,0,1,1,2,13,4,14
PJ Fletcher,Miami,11,12,23,-12,79,18,36
Parker Brown,Air Force,8,13,21,-12,60,27,37
Parker Lindauer,Maine,1,1,2,1,11,23,16
Pat Lawn,Bentley,0,4,4,1,18,29,28
Patrick Dawson,Northeastern,0,0,0,-4,7,2,16
Patrick Geary,Michigan State,5,8,13,1,38,30,32
Patrick Guzzo,Ohio State,8,7,15,-2,77,15,38
Patrick Moynihan,Notre Dame,10,14,24,7,81,12,36
Patrick Schmiedlin,Lindenwood,2,3,5,-11,41,4,24
Patrik Satosaari,Bemidji State,1,5,6,-1,24,8,31
Patriks Marcinkevics,Michigan Tech,1,1,2,-2,5,4,5
Paul Fischer,Notre Dame,2,14,16,-3,43,30,34
Paul Maust,Robert Morris,3,4,7,-16,37,41,36
Paxton Geisel,Denver,0,0,0,0,0,0,2
Payton Matsui,Alaska,5,15,20,3,65,6,34
Pete Eigner,Bowling Green,0,0,0,0,0,0,2
Peter Frates,Harvard,0,0,0,0,0,0,1
Peter Kramer,Bentley,0,3,3,-1,14,13,16
Peter Muzyka,Long Island,0,3,3,-1,21,70,33
Philip Svedebäck,Providence,0,0,0,0,0,0,35
Philip Tresca,Harvard,0,7,7,-9,30,6,16
Philip Törnqvist,Vermont,2,4,6,1,18,12,29
Philip Waugh,Mercyhurst,10,4,14,2,69,32,31
Philippe Chapleau,St. Lawrence,5,11,16,-8,33,8,39
Philippe Jacques,RIT,5,5,10,4,37,14,37
Philippe Lapointe,Michigan,1,6,7,-9,30,28,39
Pierce Charleson,Alaska,0,0,0,0,0,0,29
Pierce Patterson,Army,4,6,10,-11,43,8,31
Pierson Brandon,Colgate,5,10,15,10,79,37,34
Pito Walton,Northeastern,5,12,17,8,71,30,36
Porter Schachle,Alaska-Anchorage,8,8,16,-4,59,41,32
Powell Connor,Canisius,1,6,7,-4,61,39,35
Preston Brodziak,Long Island,3,4,7,2,50,10,28
Quinn Emerson,Bowling Green,5,6,11,1,53,10,36
Quinn Finley,Wisconsin,10,6,16,3,73,16,36
Quinn Hutson,Boston University,18,18,36,13,142,35,40
Quinn Olson,Minnesota-Duluth,4,17,21,-13,59,10,37
Quinn Rudrud,Augustana,5,7,12,-5,53,12,29
Quinton Pepper,St. Thomas,3,7,10,2,38,10,31
Raimonds Vitolins,Miami,6,11,17,-2,58,26,28
Ralfs Bergmanis,Vermont,2,10,12,-1,49,60,32
Randy Hernandez,Canisius,8,14,22,-12,83,4,37
Ray Christy,Colorado College,2,5,7,1,33,15,36
Ray Fust,Omaha,4,5,9,-6,41,12,37
Raythan Robbins,Bemidji State,0,0,0,0,0,0,3
Reagan Milburn,Lake Superior,2,6,8,0,31,10,22
Red Savage,Michigan State,10,17,27,9,94,12,38
Reed Lebster,Michigan State,6,13,19,11,76,12,35
Reese Laubach,Penn State,10,12,22,4,64,48,35
Reid Irwin,Colgate,3,10,13,5,68,24,36
Reid Pabich,Maine,1,4,5,0,21,4,21
Reilly Connors,Yale,1,4,5,-5,42,18,30
Reilly Funk,Northern Michigan,2,2,4,-5,25,10,17
Reilly Herbst,Ohio State,0,0,0,0,0,0,2
Reilly Moran,St. Lawrence,2,6,8,1,42,19,34
Remington Keopple,Cornell,0,0,0,0,0,0,2
Remy Parker,Long Island,12,5,17,-4,69,6,33
Rhett Pitlick,Minnesota,19,17,36,8,103,14,39
Rhys Bentham,Yale,6,3,9,-9,31,6,26
Rhys Chiddenton,Bemidji State,2,6,8,2,45,8,23
Ricky Lyle,Army,10,9,19,-22,75,33,34
Rico DiMatteo,Long Island,0,0,0,0,0,0,8
Rieger Lorenz,Denver,16,14,30,21,79,10,44
Riese Gaber,North Dakota,18,16,34,11,102,34,40
Rihards Simanovičs,Miami,0,8,8,-8,26,10,29
Riley Bodnarchuk,Minnesota-Duluth,2,2,4,3,19,6,30
Riley Duran,Providence,9,7,16,2,101,18,35
Riley Hughes,Ohio State,1,4,5,-3,28,19,23
Riley Stuart,Colorado College,1,2,3,-4,13,11,19
Riley Thompson,Alaska-Anchorage,9,15,24,13,74,32,34
Riley Wallack,Long Island,2,2,4,-8,40,8,28
Roan Clarke,Dartmouth,0,0,0,0,0,0,4
Robby Drazner,Miami,2,1,3,-12,31,12,33
Robby Newton,Colgate,2,1,3,-7,31,25,36
Robert Cronin,New Hampshire,4,12,16,1,38,14,33
Robert Kincaid,Canisius,2,1,3,-3,20,4,18
Roc Truman,Mass.-Lowell,1,0,1,-1,1,0,2
Ross Mitton,Colgate,11,19,30,-4,98,14,34
Ross Roloson,Lake Superior,4,10,14,4,41,4,37
Rowan Miller,Alaska-Anchorage,0,1,1,-3,10,4,10
Rutger McGroarty,Michigan,16,36,52,17,138,6,36
Ryan Alexander,Arizona State,3,7,10,7,36,10,27
Ryan Beck,Colorado College,3,17,20,4,31,26,34
Ryan Bischel,Notre Dame,0,0,0,0,0,2,36
Ryan Bottrill,Brown,3,16,19,-19,62,10,30
Ryan Brushett,Rensselaer,6,15,21,-10,57,14,37
Ryan Chesley,Minnesota,2,6,8,2,63,19,39
Ryan Conmy,New Hampshire,14,17,31,9,120,14,34
Ryan Conroy,Yale,2,11,13,-1,39,26,30
Ryan Coughlin,Mercyhurst,5,7,12,-1,37,8,27
Ryan Davies,Stonehill,1,1,2,-20,6,2,18
Ryan Drkulec,Harvard,1,2,3,-7,14,6,27
Ryan Fine,Harvard,5,5,10,-10,46,12,32
Ryan Gordon,Ohio State,1,2,3,-3,46,4,30
Ryan Greene,Boston University,12,24,36,0,76,6,40
Ryan Healey,Harvard,9,13,22,-26,73,12,29
Ryan Helliwell,Notre Dame,0,0,0,0,2,17,9
Ryan Hopkins,Maine,1,2,3,0,20,8,24
Ryan King,Stonehill,0,0,0,-7,3,8,12
Ryan Kirwan,Penn State,13,13,26,7,161,10,36
Ryan Lautenbach,Massachusetts,10,14,24,2,73,29,37
Ryan Leonard,Boston College,31,29,60,36,168,38,41
Ryan Mahshie,Connecticut,2,3,5,-3,28,4,21
Ryan Mansfield,Bentley,7,11,18,7,46,2,31
Ryan McGuire,Colgate,14,12,26,5,86,31,34
Ryan Miotto,Vermont,9,8,17,-8,59,18,35
Ryan Naumovski,Augustana,8,17,25,0,61,0,34
Ryan Nause,Bentley,1,6,7,-1,27,12,23
Ryan Nicholson,RIT,0,9,9,11,29,22,40
Ryan O'Hara,Bowling Green,10,8,18,-2,85,12,26
Ryan O'Neill,St. Thomas,7,19,26,-1,71,12,35
Ryan O'Reilly,Arizona State,9,6,15,10,61,18,37
Ryan Ouellette,Niagara,0,0,0,0,0,0,8
Ryan Richardson,Clarkson,7,16,23,7,62,12,35
Ryan Rosborough,St. Cloud State,3,2,5,-10,33,19,20
Ryan Shostak,Brown,3,2,5,-9,30,4,30
Ryan Siedem,Notre Dame,3,17,20,16,51,12,36
Ryan Sorkin,Dartmouth,1,3,4,-10,36,32,31
Ryan St. Louis,Brown,13,11,24,-8,62,4,30
Ryan Stevens,Yale,0,0,0,-2,3,0,2
Ryan Sullivan,Colgate,6,7,13,6,56,16,35
Ryan Sullivan,Miami,5,4,9,-8,41,12,29
Ryan Tattle,Connecticut,4,8,12,-8,53,22,34
Ryan Taylor,Clarkson,10,6,16,5,55,4,24
Ryan Ufko,Massachusetts,10,16,26,4,93,14,37
Ryan Upson,Bentley,6,6,12,5,39,8,27
Ryan Walsh,Cornell,12,10,22,5,73,21,35
Ryder Donovan,St. Thomas,1,0,1,2,4,4,3
Rylan Mosley,Michigan Tech,18,15,33,2,144,10,40
Rylan Van Unen,Northern Michigan,4,6,10,-5,56,55,33
Rylee Hlusiak,Sacred Heart,0,2,2,-6,21,10,25
Rylee St. Onge,Robert Morris,11,9,20,-18,102,45,38
Salvatore Evola,Bowling Green,0,0,0,0,0,0,3
Salvatore Guzzo,Harvard,0,4,4,-10,16,10,29
Sam Brennan,Air Force,3,4,7,3,36,16,36
Sam Colangelo,Western Michigan,24,19,43,19,159,23,38
Sam Deckhut,Ohio State,3,3,6,-3,16,2,29
Sam Harris,Denver,14,7,21,13,86,27,42
Sam Jacobs,Air Force,0,0,0,0,0,0,1
Sam Lipkin,Quinnipiac,15,20,35,15,98,37,39
Sam Morton,Minnesota State,24,10,34,8,151,10,37
Sam Rinzel,Minnesota,2,26,28,23,75,20,39
Sam Stange,Wisconsin,0,0,0,-2,3,4,7
Sam Stevens,Boston University,10,7,17,15,80,34,40
Samu Salminen,Connecticut,7,10,17,3,74,35,35
Samuel Duerr,Bentley,6,7,13,-11,70,12,35
Samuel Sjolund,Western Michigan,3,15,18,-1,84,10,38
Samuli Niinisaari,Massachusetts,3,9,12,2,36,4,27
Sasha Teleguine,Lake Superior,2,1,3,-6,40,29,34
Sawyer Scholl,Wisconsin,6,2,8,7,51,20,33
Scooter Brickey,Ohio State,13,13,26,-10,92,32,37
Scott Morrow,Massachusetts,6,24,30,3,113,25,37
Scout Truman,Mass.-Lowell,7,14,21,2,95,18,35
Seamus Casey,Michigan,7,38,45,4,101,14,40
Sean Behrens,Denver,4,27,31,25,69,53,44
Sean Chisholm,Dartmouth,8,9,17,9,72,11,28
Sean Donaldson,Cornell,0,0,0,-1,12,0,10
Sean James,Mercyhurst,0,1,1,-1,10,0,8
Sean Kilcullen,Mass.-Lowell,0,2,2,-9,25,25,27
Sean Vlasich,Army,0,3,3,-10,23,6,28
Sebastian Tamburro,Colgate,1,4,5,4,12,4,13
Sebastian Törnqvist,Massachusetts,0,3,3,1,11,8,14
Seiya Tanaka-Campbell,Yale,0,0,0,0,0,0,3
Seth Bernard-Docker,Bentley,0,6,6,-3,18,4,16
Seth Eisele,Omaha,0,0,0,0,0,0,8
Seth Fyten,Bowling Green,7,6,13,3,42,37,26
Shai Buium,Denver,7,29,36,33,63,14,43
Shane Lachance,Boston University,13,14,27,15,94,12,40
Shane Lavelle,Lindenwood,1,0,1,0,7,2,7
Shane Ott,Niagara,5,15,20,3,93,25,38
Shawn O'Donnell,Mass.-Lowell,0,1,1,-1,5,6,10
Shay Donovan,Augustana,2,6,8,-7,37,14,32
Simon Bucheler,Mercyhurst,0,0,0,0,0,0,8
Simon Falk,Augustana,0,7,7,-3,38,4,26
Simon Isabelle,RIT,8,10,18,3,56,29,39
Simon Jellus,Vermont,6,4,10,-5,62,2,30
Simon Labelle,Colgate,7,20,27,-5,66,17,36
Simon Latkoczy,Omaha,0,0,0,0,0,0,34
Simon Mack,Penn State,4,12,16,3,47,0,36
Simon Tassy,Wisconsin,12,16,28,12,99,47,40
Spence Evans,Brown,0,0,0,0,3,0,9
Spencer Cox,Miami,1,7,8,-9,45,16,30
Spencer Kersten,Bowling Green,9,7,16,-8,83,8,36
Spencer Schneider,Bowling Green,0,0,0,-3,11,0,12
Spencer Smith,Mercyhurst,3,5,8,4,26,0,34
Stanley Cooley,Colorado College,5,9,14,1,57,14,37
Stefan Owens,Mass.-Lowell,1,1,2,-6,29,2,34
Stefano Bottini,Canisius,4,6,10,1,31,10,23
Stepan Pokorny,Ferris State,8,10,18,-13,66,26,36
Stephen Castagna,Bentley,6,21,27,4,89,37,35
Stephen Halliday,Ohio State,10,26,36,-2,104,30,38
Stephen Willey,Army,1,1,2,-7,22,0,20
Steven Agriogianis,Mercyhurst,6,17,23,-16,60,8,35
Steven Bacovsky,Merrimack,0,0,0,0,0,0,1
Steven Bellini,Minnesota State,3,8,11,4,29,20,31
Steven Holtz,Michigan,0,5,5,9,21,35,38
Steven Townley,Dartmouth,2,4,6,-5,35,10,32
Stiven Sardaryan,New Hampshire,7,7,14,-4,48,12,32
Sullivan Mack,Cornell,7,10,17,6,44,2,29
Sully Scholle,Maine,7,4,11,1,58,10,33
Sutter Muzzatti,Rensselaer,10,15,25,-15,49,79,33
T.J. Hughes,Michigan,19,29,48,11,115,27,41
T.J. Lloyd,Alaska,3,16,19,0,66,33,34
T.J. Semptimphelter,Arizona State,0,1,1,0,0,2,26
TJ Schweighardt,Mass.-Lowell,1,3,4,-10,39,8,33
TJ Walsh,Sacred Heart,13,13,26,-12,71,6,36
Tabor Heaslip,Connecticut,1,7,8,-5,62,16,36
Taige Harding,Providence,2,6,8,-5,44,12,34
Talon Sigurdson,Clarkson,1,1,2,-4,17,10,25
Tanner Adams,Providence,6,15,21,1,63,6,35
Tanner Andrew,RIT,6,15,21,6,78,10,38
Tanner Edwards,Minnesota State,0,0,0,-1,2,4,5
Tanner Kelly,Michigan State,9,9,18,13,64,34,35
Tanner Klimpke,Robert Morris,15,11,26,-7,70,14,37
Tanner Komzak,North Dakota,0,0,0,2,1,0,4
Tanner Latsch,Northern Michigan,7,1,8,-6,22,6,8
Tanner Ludtke,Omaha,11,17,28,11,85,28,40
Tanner Main,Bentley,0,1,1,-3,16,10,13
Tanner Palocsik,Penn State,2,14,16,-1,57,8,36
Tanner Rowe,Michigan,1,0,1,-3,19,24,25
Tanyon Bajzer,Miami,0,2,2,-4,6,0,12
Taylor Makar,Massachusetts,4,5,9,2,37,22,36
Teddy Lagerbäck,Miami,1,1,2,-5,15,12,21
Teddy Wooding,Yale,1,6,7,-6,27,8,21
Theo Angesved,American Int'l,2,2,4,-3,34,2,15
Theo Wallberg,Ohio State,2,19,21,-10,30,16,38
Thomas Daskas,Miami,3,4,7,-9,34,21,36
Thomas Freel,Maine,6,16,22,4,67,8,37
Thomas Gale,Holy Cross,0,0,0,0,0,0,19
Thomas Haynes,Robert Morris,0,0,0,-5,6,4,12
Thomas Jarman,Boston University,0,0,0,0,0,0,1
Thomas Manty,Brown,2,1,3,-5,21,4,18
Thomas Richter,Union,1,0,1,1,2,0,2
Thomas Sinclair,Vermont,5,4,9,1,35,8,32
Thomas Weis,Ohio State,4,7,11,-3,48,33,37
Tiernan Shoudy,Michigan State,4,12,16,3,55,26,38
Tim Lovell,Arizona State,5,32,37,10,44,48,36
Tim Piechowski,St. Thomas,3,1,4,-7,21,4,20
Tim Rego,Cornell,2,8,10,21,37,14,35
Tim Washe,Western Michigan,2,10,12,-5,59,27,38
Timo Bakos,Lake Superior,9,15,24,-3,55,6,38
Timofei Khokhlachev,American Int'l,3,2,5,4,13,14,12
Timofei Spitserov,Vermont,7,7,14,-11,73,6,35
Timothy Heinke,Quinnipiac,0,1,1,1,5,0,6
Tobias Abrahamsson,St. Thomas,0,3,3,1,6,0,37
Tom Gangl,Robert Morris,0,1,1,4,13,6,22
Tom Messineo,Connecticut,0,11,11,8,30,2,36
Tom Willander,Boston University,4,21,25,28,38,12,38
Tomi Leppanen,American Int'l,3,6,9,8,63,39,40
Tommi Männistö,Michigan State,1,9,10,5,42,39,32
Tommy Bannister,Mercyhurst,3,7,10,-6,31,4,27
Tommy Bergsland,Colgate,5,21,26,-1,50,16,36
Tommy Lyons,Harvard,0,0,0,-11,20,2,29
Tommy Middleton,Colorado College,4,4,8,-4,52,8,36
Tommy Pasanen,Bowling Green,1,6,7,-12,49,20,29
Tommy Scarfone,RIT,0,0,0,0,0,0,36
Tomáš Mazura,St. Lawrence,6,14,20,-5,53,12,34
Tony Achille,Arizona State,0,3,3,1,13,7,12
Tony Andreozzi,Brown,2,3,5,-1,36,6,30
Tony Follmer,Bemidji State,1,4,5,5,23,19,28
Tony Malinowski,Minnesota State,0,4,4,2,9,4,13
Travis Shoudy,Ferris State,4,17,21,-8,83,14,36
Travis Treloar,Quinnipiac,12,12,24,8,71,14,30
Trent Burnham,Lindenwood,0,0,0,0,0,2,27
Trent Sambrook,Mercyhurst,3,10,13,-2,29,14,28
Trevor Bishop,Western Michigan,0,0,0,-3,6,0,10
Trevor Griebel,Merrimack,2,4,6,6,12,6,19
Trevor Janicke,Notre Dame,9,7,16,6,82,16,32
Trevor Kukkonen,Michigan Tech,0,0,0,0,1,2,2
Trevor Ledonne,Robert Morris,0,1,1,-2,31,43,29
Trevor Russell,Michigan Tech,0,7,7,6,33,30,38
Trevor Smith,Army,1,1,2,-13,13,2,12
Trevor Taulien,Ferris State,2,6,8,-8,30,20,27
Trey Augustine,Michigan State,0,1,1,0,1,0,35
Trey Funk,Canisius,7,6,13,-2,50,6,34
Trey Taylor,Clarkson,4,13,17,20,86,27,35
Tristan Amonte,Boston University,0,0,0,0,4,0,8
Tristan Broz,Denver,16,24,40,20,88,13,43
Tristan Fraser,Connecticut,7,4,11,-1,27,33,35
Tristan Lemyre,Denver,2,4,6,3,16,0,24
Tristan Sarsland,Clarkson,5,7,12,8,57,14,34
Trym Lokkeberg,Dartmouth,1,0,1,-5,10,8,31
Tucker Hartmann,Yale,0,1,1,-1,4,6,10
Tucker Hodgson,Bentley,1,4,5,3,32,22,35
Tucker McIntosh,St. Lawrence,0,5,5,-2,32,12,34
Tucker McRae,Dartmouth,3,4,7,-10,23,14,27
Tucker Ness,Arizona State,0,2,2,1,8,60,18
Ty Daneault,Merrimack,13,8,21,-5,88,33,34
Ty Gagno,Holy Cross,3,10,13,7,64,16,33
Ty Gallagher,Boston University,0,5,5,3,24,14,37
Ty Jackson,Arizona State,6,12,18,6,46,14,21
Ty Mueller,Omaha,11,15,26,9,102,33,40
Ty Murchison,Arizona State,3,4,7,7,46,62,37
Ty Naaykens,St. Lawrence,7,7,14,-11,60,45,39
Tyler Carpenter,Notre Dame,5,4,9,1,35,16,33
Tyler Catalano,Cornell,1,4,5,-1,19,14,24
Tyler Coffey,Colorado College,5,0,5,-2,47,10,24
Tyler Cristall,St. Lawrence,7,9,16,-12,78,12,39
Tyler DesRochers,Mercyhurst,0,2,2,-9,17,10,21
Tyler Duke,Michigan,2,14,16,12,59,50,38
Tyler Dunbar,Colorado College,1,0,1,1,19,8,17
Tyler Fukakusa,RIT,9,19,28,19,58,18,39
Tyler Gaulin,Mercyhurst,0,0,0,-4,6,8,8
Tyler Ghirardosi,Holy Cross,14,13,27,13,109,23,39
Tyler Gratton,Arizona State,12,6,18,-7,68,18,36
Tyler Haskins,Minnesota State,4,2,6,0,18,2,18
Tyler Hotson,Rensselaer,13,9,22,-3,64,32,37
Tyler Kopff,Brown,6,12,18,-4,94,16,30
Tyler Mahan,RIT,6,7,13,10,44,16,35
Tyler Muszelik,New Hampshire,0,0,0,0,0,0,8
Tyler Nasca,Mercyhurst,0,1,1,-4,10,6,24
Tyler Paquette,Penn State,6,3,9,-14,53,8,27
Tyler Rollwagen,Omaha,3,5,8,1,20,30,38
Tyler Rubin,Princeton,4,9,13,2,38,22,30
Tyler Schleppe,Ferris State,3,7,10,-6,44,11,25
Tyler Shea,Brown,0,0,0,0,0,0,10
Tyler Spott,Sacred Heart,1,4,5,-4,26,16,27
Tyler Wallace,Niagara,13,17,30,2,64,17,39
Tyler Watkins,Union,8,8,16,-1,67,4,36
Tyler Williams,Lake Superior,3,0,3,-9,35,6,21
Tyler Young,Merrimack,0,1,1,-4,21,25,12
Tynan Ewart,St. Cloud State,0,5,5,7,8,2,19
Tyrell Boucher,Northern Michigan,0,1,1,-4,13,4,21
Tyrone Bronte,Michigan Tech,6,8,14,0,46,23,35
Tyson Dyck,Wisconsin,0,9,9,13,32,21,28
Tyson Gross,St. Cloud State,7,13,20,2,63,16,34
Tyson Jugnauth,Wisconsin,0,2,2,-2,15,8,13
Uula Ruikka,Augustana,5,9,14,-6,82,30,29
Valtteri Piironen,Long Island,3,9,12,-3,37,18,29
Veeti Miettinen,St. Cloud State,20,15,35,4,128,0,37
Verner Miettinen,St. Cloud State,4,19,23,-3,52,8,38
Victor Czerneckianair,Quinnipiac,7,7,14,12,53,12,39
Victor Mancini,Omaha,4,6,10,7,78,8,40
Victor Ostman,Maine,0,0,0,0,0,0,21
Viking Gustafsson Nyberg,Northern Michigan,2,1,3,0,25,24,33
Viktor Hurtig,Michigan State,1,1,2,1,9,6,9
Ville Immonen,Union,8,16,24,-6,55,18,36
Vince Corcoran,Bemidji State,2,9,11,-14,32,14,34
Vincent Salice,Army,4,6,10,-4,57,12,34
Vinny Borgesi,Northeastern,5,23,28,7,76,10,34
Vinny Duplessis,Quinnipiac,0,0,0,0,0,0,30
Walter Zacher,Robert Morris,5,17,22,-6,82,22,33
Warren Clark,St. Cloud State,0,3,3,-6,15,8,31
Will Arquiett,St. Lawrence,0,3,3,-5,22,12,30
Will Gavin,Air Force,19,17,36,-12,133,24,38
Will Gilson,Alaska-Anchorage,3,12,15,4,82,67,34
Will Hambley,Alaska,0,0,0,0,0,0,4
Will Hilfiker,Alaska,1,0,1,6,8,15,12
Will Hillman,Minnesota State,2,3,5,0,44,12,36
Will Howard,Augustana,4,5,9,-6,40,6,25
Will Magnuson,Bemidji State,0,5,5,3,32,16,32
Will Margel,Mercyhurst,6,13,19,-7,63,10,31
Will Richter,Yale,1,1,2,-7,11,0,14
Will Smith,Boston College,25,46,71,25,130,14,41
Will Staring,Air Force,1,8,9,-3,33,20,33
Will Svenddal,Augustana,0,2,2,-4,7,8,19
Will Traeger,Boston College,0,0,0,-1,2,2,8
Will Vote,Boston College,1,7,8,2,15,4,20
Will Zapernick,Vermont,3,9,12,-4,66,14,35
William Dineen,Yale,7,2,9,-4,42,27,20
William Elias,Holy Cross,0,0,0,0,0,0,1
William Gramme,Wisconsin,0,0,0,0,0,0,4
William Hakansson,Lake Superior,0,0,0,0,0,0,5
William Hallén,Miami,3,7,10,-10,32,8,23
William Lawson-Body,Alaska,1,4,5,4,15,15,10
William Smith,Ohio State,1,4,5,2,44,22,32
William Tripp,Stonehill,0,7,7,-19,15,21,24
William Troutwine,Holy Cross,0,2,2,5,8,2,18
William Whitelaw,Wisconsin,10,7,17,3,123,17,37
Winter Wallace,Cornell,1,1,2,-2,15,12,24
Wyatt Schingoethe,Western Michigan,0,4,4,4,27,2,24
Wyatt Schlaht,Brown,1,0,1,-2,2,0,10
Xan Gurney,Long Island,1,2,3,4,6,36,12
Xander Lamppa,Penn State,3,13,16,-3,85,40,35
Xavier Henry,Vermont,1,1,2,0,11,22,22
Xavier Jean-Louis,Alaska,2,2,4,6,20,20,26
Xavier Lapointe,RIT,2,8,10,12,37,29,28
Zaccharya Wisdom,Colorado College,10,10,20,7,56,22,33
Zach Bookman,Merrimack,4,24,28,-13,51,30,33
Zach Dubinsky,Vermont,2,9,11,3,30,20,30
Zach Faremouth,Ferris State,6,6,12,-3,55,24,34
Zach Hahn,New Hampshire,0,0,0,0,0,0,1
Zach Krajnik,Minnesota State,1,6,7,4,25,2,27
Zach Michaelis,Northern Michigan,0,3,3,-1,4,2,9
Zach Okabe,St. Cloud State,10,14,24,-4,87,21,38
Zach Plucinski,Notre Dame,0,4,4,5,29,41,36
Zach Sandy,Minnesota-Duluth,0,0,0,0,0,0,1
Zach Schulz,Wisconsin,2,4,6,3,24,6,34
Zach Stejskal,Minnesota-Duluth,0,0,0,0,0,0,20
Zach Tupker,Quinnipiac,6,15,21,20,72,24,39
Zach Urdahl,Omaha,13,12,25,3,77,4,34
Zachary Aughe,Lindenwood,3,7,10,-7,40,39,28
Zachary Borgiel,Merrimack,0,0,0,0,0,2,16
Zachary Nazzarett,Long Island,3,9,12,1,30,4,19
Zack Rose,Augustana,0,1,1,0,0,0,15
Zackary Tonelli,Brown,1,2,3,-11,19,6,30
Zak Galambos,Western Michigan,9,12,21,16,97,39,38
Zakary Karpa,Harvard,4,4,8,-8,37,6,31
Zane Demsey,Miami,1,3,4,-2,19,25,26
Zeev Buium,Denver,11,39,50,33,75,20,42
